Features	Target
¿ haber mayor brecha salarial género México ? Banxico realizar análisis brecha salarial género región México , resultado demostrar norte ser haber mayor diferencia remuneración hombre mujer .	Economia
Intel Amazon firmar acuerdo comercial mercado recibir bien empresa tecnología trabajar conjunto coinversión diseño chip personalizado negocio nube big tech : AWS .	Ciencia
finalizar   temporada Rodri Manchester . Rodri , mediocampista Manchester City , perder resto temporada someter él ayer cirugía ligamento anterior cruzado .	Deportes
"Fed bajar tasa medio punto porcentual ; aducir "" confianza "" control inflación responsable política monetario prever tipo referencia Reserva Federal caer medio punto porcentual final año ."	Economia
Chapultepec estar listo atender presente enfrentar futuro : Orozco Bosque Chapultepec estar listo atender presente encarar futuro , asegurar Jornada artista veracruzano Gabriel Orozco , concluir labor coordinador proyecto Chapultepec : Naturaleza Cultura , cuarto sección , ya remodelado , inaugurar hacer día .	Cultura
plan sustituir importación Asia nearshoring tornar difícil primero siete mes año , importación México Asia alcanzar 141.219 millón dólares ; China representar 51% total .	Economia
Verstappen , castigado   lenguaje “ grosero ” ; Norris liderar práctica Max Verstappen caer nuevo espiral error perseguir Red Bull . jornada ensayo libre gran Premio Singapur , tricampeón mundial Fórmula 1 lograr cuarto mejor tiempo primero ronda , luego ser lugar 15 , quejar él falta adherencia goma . quedar 1.2 segundo líder Lando Norris ( McLaren ) , brillar circuito urbano Mari-na Bay delante monegasco Charles Leclerc Carlos Sainz ( Ferrari ) . mexicano Sergio Pérez ubicar octavo puesto .	Deportes
Miguel Díaz Reynoso * : Cuadernos Habana Encuentro cuaderno referencia asalto Cuartel Moncada . quizá deber empezar preparativo decidir llevar él cabo 26 julio .	Cultura
“ Misión cumplido ” “ Misión cumplido ” , decir artista Gabriel Orozco cerrar ciclo casi seis año coordinador proyecto Chapultepec : Naturaleza Cultura , 24 septiembre , presidente Andrés Manuel López Obrador inaugurar cuarto sección último faltar concluir bosque urbano .	Cultura
Alcaraz dar triunfo decisivo Europa , campeón Copa Laver París . Europa conquistar ayer Copa Laver tenis combinado resto mundo gracias victoria español Carlos Alcaraz Taylor Fritz último duelo singl .	Deportes
debajo máscara estar rostro abogado , comerciante tortero José Orlando Regalado Alonso ser conocer arena Rey Destroyer . lucha Black Spider Jr , 2 marzo Monterrey , regiomontano fallecer 22 año caída ocasionar severo daño cerebral . 10 día estar internado , luchador Park , Silver Star Latin Lover recaudar fondo ayudar familia , debido haber problema pago atención médico . ser más reciente muerte tener lamentar deporte . no ser cansancio dolor , único poder detener gladiador enmascarado ser lesión fulminante . modo vida estar relacionado riesgo .	Deportes
reserva internacional alcanzar marca histórico reserva internacional cerrar semana concluir 20 septiembre saldo 226 mil 465 millón dólares , incremento 356 millón dólares relación semana precedente , revelar Banco México ( BdeM ) .	Economía
Cotiza peso prácticamente cambio espera recorte tasa BdeM Ahora incógnita política monetario México ser recorte tasa referencia cuarto medio punto porcentual , Banco México ( BdeM ) despejar jueves . tanto , peso mexicano operar ayer cautela .	Economía
RappiCard alcanzar 5.107 millón pesos cartera crédito empresa resaltar partir estrategia ser ofrecer proceso solicitud aprobación solo dos minuto entrega tarjeta físico 30 minuto .	Economia
¿ usar nuevo función texto Instagram ? nuevo herramienta texto incluir más fuente efecto , así posibilidad agregar texto superpuesto publicación feed .	Ciencia
Dodgers Yanquis , primero sembrado Ángeles . , Dodgers Ángeles Yanquis Nueva York asegurar sábado ser primero sembrado playoff , dominicano José Ramírez , Guardianes Cleveland , colocar jonrón ingresar selecto club 40-40 .	Deportes
BMV ganar semana ; peso perder 28 centavo peso revertir ganancia inicial , día después impulso registrado anuncio Banco México recortar tasa interés .	Economía
2026 , Petróleos Mexicanos requerir 19 mil millón dólares gobierno federal Petróleos Mexicanos ( Pemex ) requerir gobierno federal 19 mil millón dólares 2026 cubrir necesidad efectivo , operativo pago deuda , asegurar Roxana Muñoz , vicepresidenta analista senior calificadoro Moody’s .	Economía
Gasolinas diésel ir primero mes subsidio Brindar menor estímulo haber permitir recaudar mayor ingreso secretaría Hacienda ; enero agosto año , haber recaudar 82% más dinero IEPS combustible .	Economia
Tribunal dar 5 día X validar representante legal Brasil Río Janeiro . , red social X nombrar representante legal Brasil , exigencia volver funcionar país , seguir suspendido cumplir requisito judicial . Tribunal Supremo Brasil dar plataforma social X , propiedad Elon Musk , cinco día presentar documento validir nuevo representante legal país , mostrar sábado decisión judicial .	Economía
entusiasta asistente OSM festejar Islas CU 114 año UNAM rugido puma resonar volumen sábado Islas Ciudad Universitaria ( CU ) , Universidad Nacional Autónoma México ( UNAM ) celebrar 114 aniversario concierto memorable cargo Orquesta Sinfónica Minería ( OSM ) .	Cultura
Norris conseguir po él   GP Singapur ; Checo , fuera top-10 mexicano Sergio Pérez ( Red Bull ) entrar socavón . Arrancó des-de fondo , esperanzado neumático ayudar remontar , terminar lejos dos piloto disputar título mundial Fórmula 1 calificación gran Premio Singapur . ubicado lugar 13 , tapatío finalizar carrera poco memorable respecto rendimiento Lando Norris ( McLaren ) tricampeón mundial Max Verstappen , primero segundo parrilla salida , respectivamente .	Deportes
Anahit María salir gran Bretaña Armenia exhibición Diosa Madre : Anahit María , realizado originalmente Museo Británico , ser prestar manera exclusivo seis mes Museo Historia Armenia , ubicado ciudad Yerevan . muestra ser reflexión papel femenino materno distinto deidad variado cultura . imagen , cabeza estatua bronce diós Anahit , perteneciente cultura persa , datar siglo i antes Cristo .	Cultura
estancar producción grano   sexenio producción grano oleaginosa México haber incrementar 37 ciento entrada vigor Tratado libre Comercio América Norte ( TLCAN ) , actualmente Tratado México , Estados Unidos Canadá ( T-MEC ) , fecha ; embargo , sexenio crecimiento haber estancar , revelar dato oficial .	Economía
“ feminismo devolver dignidad existencia , arte también ” : Sofía Weidner “ no prometer salir alegre mente tranquilo exposición . no querer generar arte causar comodidad ” , confesar Sofía Weidner inauguración Musas negro , Museo Ciudad México . Emociones trist , dolorosa furiosa estar plasmada obra hoy trasciendar ser ver público significar cobijo , abandono soledad sueño cumplido . “ así feminismo devolver dignidad existencia , arte también ” , declarar creadora .	Cultura
repuntar julio economía : Inegi economía mexicano crecer más esperado julio , debido incremento ‘ inusual ’ sector agrícola , ganadero pesca , revelar Instituto Nacional Estadística Geografía ( Inegi ) .	Economía
Fitch S&P descartar degradar calificación México reforma judicial agencia calificadora ver finanza sólido esperar prudencia fiscal Claudia Sheinbaum .	Economia
Espartaco Martínez trasladar libro obra Sutra corazón bailarín coreógrafo butoh , Espartaco Martínez , haber interpretar ocasión obra Sutra corazón , experiencia sensorial torno condición humano necesidad liberación emocional , presentar hoy libro vestíbulo Casa Miguel Alemán Complejo Cultural Pinos Chapultepec enseñanza relacionado volver origen vida .	Cultura
Manuel Ahumada , dibujante “ demasiado viejo punk , mucho joven morir ” ser “ demasiado viejo punk , mucho joven morir ” , decir Manuel Ahumada ( 1956-2014 ) Gonzalo Rocha , ambos monero colaborador Jornada . “ día elevar más ahora mirar cosmos , acompañado dios azteca , ángel astronauta Apolo 11 ” , agregar referencia día aquel  fallecer personaje ser frecuente imaginario obra .	Cultura
Google salir multa antimonopolio 1.670 mmd caso comenzar supuesto dominio anticompetitivo empresa mercado publicidad línea .	Ciencia
Microsoft invertir mil 300 mdd México infraestructura IA nar	Economía
ahora usuario Uber también deber verificar identidad Uber implementar nuevo verificación identidad pasajero , objetivo ofrecer mayor seguridad conductor evitar fraude plataforma .	Ciencia
Proyecto ministro Pérez Dayán impedir UIF bloquear cuenta bancario lavado ministro Alberto Pérez Dayán proponer endurecimiento requisito Unidad Inteligencia Financiera ( UIF ) poder asegurar cuenta bancario titular ser sospechoso operación lavado dinero .	Economía
Peligra economía México Trump ganar cumplir arancel : Moody's agencia calificadoro anticipar economía mexicano sufrir recesión 2025 mayor inflación .	Economia
Intel lograr acuerdo 3.500 mdd fabricar chip ejército tratar programa secreto , llamado Secure Enclave , buscar establecer producción chip avanzado aplicación militar Inteligencia .	Ciencia
primero vez 2 año , tasa Cetes bajo 10% después casi dos año ofrecer rendimiento anual doble dígito , tasa interés Certificados Tesorería Federación ( Cetes ) haber caer debajo 10 ciento . analista , indicar mercado anticipar Banco México ( BdeM ) reducir tasa referencia próximo jueves línea Reserva Federal Estados Unidos .	Economía
Brasil ! Brasil ! revelar visión vibrante Modernismo Berna . exposición Brasil ! Brasil ! : The Birth of Modernism ( ¡ Brasil ! ¡ Brasil ! : nacimiento Modernismo0 , inaugurado Zentrum Paul Klee , ofrecer visión vibrante movimiento artístico país sudamericano largo obra 10 artista , cinco autodidacta poco conocido internacionalmente . 130 obra expuesto haber salir Brasil primero vez . muestra coincidir temáticamente Bienal Venecia , más mitad artista aquí presente también participar .	Cultura
sufrir rechazo Alemania reserva Italia posible fusión unicredit Commerzbank Milán . jefe banco italiano UniCredit , Andrea Orcel , participar viernes reunión virtual representante alemán Commerzbank , convertir él mayor inversor privado prestamista alemán , informar Reuters fuente conocedor asunto .	Economía
Científicos descubrir coral ser capaz retener microplástico Madrid . nuevo técnica detección microplástico descubrir tres parte anatomía coral ( mucosidad superficial , tejido esqueleto ) contener clase desecho artificial .	Ciencia
México ir facilitar respaldar inversión EU : Marcelo Ebrard Luego aprobado reforma judicial , próximo secretario Economía reviveír postear video red social decir integración dos economía avanzar paso acelerado .	Economia
"Meta presentar Quest 3S , versión "" económico "" visor realidad mixto Meta calificar dispositivo proveedor   “ experiencia increíble precio inigualable ” ."	Ciencia
e-commerce chino conquista bolsa valor dueño Alibaba , Temu JD conquistar e-commerce mundo , diversificar negocio .	Ciencia
Aterriza nave Soyuz misión récord EEI Moscú . cápsula Soyuz transportar dos cosmonauta rusosy astronauta estadunidense Estación Espacial Internacional aterrizar Kazajstán , poner fin estadía récord pareja ruso .	Ciencia
Economía mexicano crecer 0.6% julio actividad primario encabezar crecimiento económico país séptimo mes año .	Economia
ser audiencia querer conquistar iphone 16 Apple ser consciente usuario iphone 15 difícilmente ir renovar smartphone , haber segmento poder seducir .	Ciencia
Copa Laver equipo resto mundo tomar ventaja 8-4 Copa Laver selección Europa . triunfo estadunidens Taylor Fritz ( imagen ) Frances Tiafoe alemán Alexander Zverev ruso Daniil Medvedev , respectivamente , ser fundamental comandado John McEnroe tomar delantera justa definir hoy campeón acumulir 13 punto Berlín .	Deportes
Toro finalizar lugar 12 Mundial Ciclismo pedalista mexicano Isaac Toro ubicar lugar 12 prueba contrarreloj categoría Sub 23 Mundial Ciclismo Ruta , disputar Zurich .	Deportes
Ricardo Yáñez : Isocronías siete escritora haber reunir Minerva Aguilar Temoltzin , autoro Vuelo letra , libro nacido recital homónimo ofrecido escritora tlaxcalteca organizado Asociación Escritores México . decir Obed González , director Literatura Feria Internacional Libro Coyoacán , – auspiciadorar volumen ánimo representativo considerar lírica voz femenino – , ser posible palpar “ ser lenguaje , ser flexibl constante transformación ” . vayar sucintamente poeta – nacido años 50 80 – :	Cultura
Microsoft usar energía nuclear alimentar Inteligencia Artificial acuerdo Microsoft Constellation Energy permitir reactivar unidad planta nuclear Three Mile Island cubrir creciente necesidad energético .	Ciencia
Inversión conectividad no caer pese política judicial : Neutral Networks CEO compañía Neutral Networks , enfocado infraestructura crítico , decir necesidad conectividad nivel usuario empresa ser más fuerte agenda política .	Ciencia
impulsar CRE infraestructuro auto eléctrico disposición administrativo materia electromovilidad emitido Comisión Reguladora Energía ( CRE ) no sólo impulsar desarrollo infraestructura uso automóvil eléctrico híbridos , también ordenamiento Sistema Eléctrico Nacional ( SEN ) , acuerdo regulador .	Economía
Sinner , “ decepcionado ” apelación AMA Roma . tenista número mundo Jannik Sinner decir estar “ mucho decepcionado sorprendido ” , después Agencia Mundial Antidopaje ( AMA ) decidir impugnar decisión Agencia Integridad Tenis Internacional determinar no haber culpabilidad dos positivo dopaje .	Deportes
nintendo The Pokémon Company demandar creador Palworld empresa japonés iniciar acción legal contra Pocketpair , debido infracción patente desarrollar llamado “ Pokémon arma ” .	Ciencia
Usuarios reportar alerta sísmico nunca llegar celular IFT haber asegurar hoy empresa enviarir mensaje emergencia sismos nunca llegar . Telcel asegurar alerta depender regulador .	Ciencia
endeudamiento mexicano exterior representar 35% PIB Banco México ( Banxico ) dar conocer segundo trimestre año reducir endeudamiento mundo 42% reportado primero trimestre .	Economia
Inversiones México mantener , pese débil Estado Derecho : UBS banco inversión decir México mantener inversión , aprovechar potencial ofrecer nearshoring .	Economia
México registrar déficit comercial 4.868 mdd agosto exportación mexicano caer 1% importación crecer 5.7% , acuerdo Inegi .	Economia
Traspié peso espera recorte tasa BdeM peso mexicano debilitar frente dólar miércoles , víspera anuncio política monetario Banco México ( BdeM ) .	Economía
Pekín recortar tasa estimular economía Pekín . Banco Central China anunciar ayer nuevo medida impulsar economía , recorte tasa interés , incluir referencia hipotecaria , así reducción depósito banco deber mantener reserva .	Economía
Desacelera inflación anual cuarto quincena consecutivo inflación general primero quincena septiembre México desacelerar 4.66 ciento anual , menor nivel segundo quincena mayo 2024 , revelar cifra Instituto Nacional Estadística Geografía ( Inegi ) .	Economía
salario , programa social remesa mantener consumo México pese inflación mayor tasa interés , consumo privado México haber ser pilar economía , tendencia quedar tiempo , advertir analista .	Economia
Enrique Dussel Peters * : China : ¿ desarrollo través política industrial ? enfatizar   colaboración 11 septiembre año profundo competencia Estados Unidos China liderazgo tecnológico global . haber ser impensable todavía hacer dos década principios siglo xxi , lema “ China barato ” .	Economía
Compras maíz Estados Unidos incrementar 23% sexenio contexto producción grano básico haber estancar , administración presidente Andrés Manuel López Obrador terminar incremento aproximadamente 23 ciento volumen importación maíz Estados Unidos .	Economía
¿ funcionar canje teléfono Mercado libre ? Mercado libre lanzar nuevo programa llamado Trade smartphón , poder canjear antiguo celular modelo nuevo .	Ciencia
Google demandar Microsoft supuesto monopolio nube denuncia ser presentar Comisión Europea , anunciar propio Google .	Ciencia
abuelita lucha libre , emblema aficionado fiel espectáculo deportivo interpelar público protagonista lucha libre . lejos ser simple espectador , ahí asistente ser actor reparto . exigir piedad condenar sufrimiento conside-ran merecer . más hinchada entusiasta , aficionado pancracio ser elenco veces estrellas . representar protagonista butaca inolvidable doña Virginia Aguilera , conocido abuelita lucha libre , más medio siglo representar aficionado fiel apasionado .	Deportes
Enrique Galván Ochoa : Dinero presidenta República     tomar posesión próximo martes , Claudia Sheinbaum Pardo , asistir congreso nacional Morena decir no ser partido Estado ; haber distancia . pedir abdicar título jefa partido , ya ser jefa Gobierno , jefa Estado comandanto suprema fuerza armado . organización guinda enarbolacer bandera 4t. ser fundar presidente Andrés Manuel López Obrador . haber anunciar mil vez retirar quinta Palenque , , asegurar , llevar vida aislamiento política político . incluso no recibir amigo . dos círculo más íntimo ser elegir dirigir formalmente partido : Luisa María Alcalde , presidenta Andrés Andy López Beltrán secretario Organización . ser ojo voz .	Economía
ganar América Campeones Cup nar	Deportes
Vilma Fuentes : entusiasmo melancolía encuentro deportivo Juegos Olímpicos Copa Mundial futbol provocar amplio movimiento entusiasmo envidiar político estrella cine . detenar segundo observar aumento pasión suscitar medida desarrollar , poder sentir curiosidad causa .	Cultura
Cruz Azul , intratable ; vence 1-0 Chivas afianza superliderato haber partido marcar agenda Cruz Azul . después clásico joven América , rivalidad Guadalajara tener valor especial . peso escenario importante , Máquina volver cantar victoria estadio Ciudad Deportes ( 1-0 ) mantener él único líder Liga Mx seguir carrera campeonato .	Deportes
Brasil desbloquear cuenta Starlink X transferencia 3 mdd juez Supremo Tribunal decir levantamiento ordenar cantidad transferido arca Brasil alcanzar total X deber país concepto multa .	Ciencia
Seguridad energético , amenazado nivel mundial tensión geopolítica : WEF transición energético nivel global observar avance , particular economía desarrollado , así China Brasil . no obstante , equidad haber retroceder tensión geopolítica causar incertidumbre seguridad energético , revelar informe Foro Económico Mundial ( WEF , sigla inglés ) .	Economía
Intel aplazar proyecto instalar fábrica Alemania Polonia anuncio presentar después revelarir empresa recibir 3.000 millón dólares gobierno estadounidense fabricar semiconductor .	Ciencia
Guadalajara dejar escapar valioso triunfo ; igualar 1-1 Monterrey partido intensidad polémica arbitral incluido , Chivas dejar escapar importante triunfo empatar 1-1 Monterrey duelo jornada 10 torneo Apertura 2024 , disputado ayer estadio Akron .	Deportes
Pemex Infonavit , ser Octavio Romero Oropeza presidenta electa , Claudia Sheinbaum , dar conocer Romero Oropeza estar frente Instituto Fondo Nacional Vivienda Trabajadores .	Economia
Pumas sufrir más , rescatar victoria 1-0 Xolos Pumas sufrir más , rescatar domingo importante triunfo 1-0 Xolos Tijuana , resultado catapultar zona liguilla , duelo correspondiente jornada nueve torneo Apertura 2024 Liga Mx , efectuado estadio Olímpico Universitario .	Deportes
inflación cede , Banxico enfrentar más reto bajar tasa interés volatilidad tipo cambio generado avance reforma judicial representar freno banco central   bajar tasa interés referencia .	Economia
CASA celebrar taller creativo tamal Día Nacional Maíz Nativo Oaxaca , Oax . , celebrar Día Nacional Maíz Nativo , conmemorar hoy , Asociación Civil Francisco Toledo realizar colaboración Fundación Alfredo Harp Helú Oaxaca ( Fahho ) actividad espacio fundado artista juchiteco ( 1940-2019 ) , luchar defensa grano escala estatal nacional .	Cultura
Banxico sólo tener espacio hacer recorte 25 punto analista considerar banco central deber tener cautela bajar tasa periodo volatilidad descartar hacer recorte 50 punto hacer Reserva Federal .	Economia
dos olímpico conquistar   Zúrich campeón olímpico Remco Evenepoel ( imagen ) Grace Brown conquistar ayer prueba contrarreloj Mundial Ciclismo , celebrar Suiza . Brown , australiana 32 año , proclamar campeona mundo primero vez quedar segundo último dos año , Evenepoel revalidar título 46.1 kilómetro Zúrich , tiempo 53 minuto 2 segundo . belga 24 año competir carrera ruta domingo .	Deportes
jubilación digno complicar vez más mexicano quinto parte empleado país contemplar jubilar él 66 año más , 86% admitir ahorrar menos deber hacer él actualidad .	Economia
BdeM recortar tasa cuarto punto , anticipa encuesta Analistas económico consultado Citibanamex anticipar nuevo recorte 0.25 punto porcentual tasa interés referencia Banco México ( BdeM ) reunión próximo semana , estimar ubicar 10 ciento cierre 2024 .	Economía
China sufrir exceso ... leche mercado leche China enfrentar situación complicado exceso oferta , bajo demanda pérdida millonario .	Economia
sexenio AMLO , banca ganar más un billón pesos largo sexenio presidente Andrés Manuel López Obrador , conjunto banco privado operar país haber ganar poco más un billón pesos , resultado histórico colocar sector mejor ser gobierno Cuarta Transformación , afirmar especialista .	Economía
David Márquez Ayala : Reporte económico múltiple logro     administración ahora terminar , producción alimento avance autosuficiencia no ser , desafortunadamente , . producción cuatro grano básico alimentación mexicano ( maíz , trigo , frijol arroz ) ascender 2023 31.9 millón tonelada , apenas 1.0% producción 2018 ( Gráfico 1 ) . producto , periodo producción maíz aumentar 1% , trigo 18.1 , decreceír frijol – 38.3% arroz 11.2% .	Economía
Tigres rescatar empate dos León ; ser sublíder polémica decisión arbitral , Tigres rescatar empate 2-2 León gol último minuto argentino Juan Brunetta . universitario valer criterio silbante Daniel Quintero Huitrón , invalidar dos tanto esmeralda inclinar balanza favor , igualar encuentro .	Deportes
Pemex requerir 50.200 mdd tres primero año Sheinbaum , prever Moody's apoyo gobierno calificación real Pemex ser Ca , es decir 80% incumplimiento compromiso financiero .	Economia
México eu acordar Sader supervisar aguacate exportación gobierno México Estados Unidos acordar transferencia responsabilidad agilizar comercio .	Economia
obra Nombres combate reúnir foro Gruta historia vida resistencia haber historia merecer ser contar , no sólo resultar dolorosa heroico , “ ser testimonio vida , cariño resistencia ” , afirmar Martín López Brie , dramaturgo director Nombres combate , obra documental presentar partir hoy foro Gruta , haber enfrentar dificultad propio pandemia .	Cultura
Tigres batallar vencer último lugar torneo duelo ser más complejo esperado , Sebastián Córdova lograr dar él Tigres triunfo 1-0 sotanero Ciudad Juárez , jornada nueve torneo Clausura 2024 Liga Mx . victoria , felino escalar segundo puesto tabla general 20 unidad , dos punto diferencia líder Cruz Azul .	Deportes
Samsung abrir puerta : así convivir humano brazo mecánico comenzar planta producción refrigerador , hoy ser centro más importante Samsung mundo .	Ciencia
Fotografiar ser pretexto buscar yo : Graciela Iturbide Arropada largo ovación , fotógrafa Graciela Iturbide recibir Medalla Bellas Artes Oro 2024 Artes Visuales , otorgar Instituto Nacional Bellas Artes Literatura ( Inbal ) , icónica imagen , conjuguir documental poético , formar parte esencial acervo gráfico contemporáneo México .	Cultura
Revolut planear operar primero mes 2025 Juan Guerra , director general firma , decir esperar arrancar operación siguiente año cuenta débito nivel 4 transferencia internacional .	Economia
medio crisis , industria gaming buscar nuevo modelo negocio despido haber marcar año videojuego , especialista apuntar ser nuevo oportunidad diversificar contenido creador independiente .	Ciencia
Beneficios social seguro médico , deuda pendiente haber frase lucha libre revelar realidad desafortunado gladiador : “ saber ir subir , no va-mos bajar ” . halo peligro acompañar dentro cuadrilátero , casi haber sufrir lesión alto grado incluso no haber volver despertar caer lona ; pese riesgo , mayo-ría trabajar seguro médico , sólo confianza salir ileso , mejor aún , vivo .	Deportes
impacto nearshoring tendencia laboral MetLife México escasez talento calificado , importancia beneficio competitivo necesidad cultura organizacional sólido ser principal desafío enfrentar empresa	Economia
Raúl Pineda sacar luz oscuridad dolor tragedia atravesar país Traer luz oscuridad ser labor artista Raúl Pineda , don memoria fotográfico excesivo persistencia técnica antiguo grabado mezzotinta retrato horror desencajado violencia México .	Cultura
Chaquito estar fuera tres mes nar	Deportes
Lactalis reducir casi 10% adquisición leche Francia grupo Lactalis , líder mundial sector lácteo , anunciar reducir final año volumen leche recogido granja francés destinado mercado internacional , centrar él producto vendido Francia .	Economía
Mercado Pago hacer oficial : presentar solicitud ser banco digital cuenta digital buscar aprobación licencia bancario Comisión Nacional Bancaria Valores ofrecer servicio banca múltiple .	Economia
Yuriria Iturriaga : No sólo pan ... sorprender categoría ser ajeno mayoría persona haber rodear vida decenio , sorpresa no ser sólo sentir diferenceír compatriota mexicano , , caso , repentino nostalgia paladar , olfato tacto intrabucal infinito mundo pan pastel , casualidad , pertenecer mundo trigo , es decir , gluten atacar oriental mesoamericano viejo cepa , no note …	Cultura
ios 18 , incluir nuevo versión actualizar iphone todavía no haber integrar Apple Intelligence , actualización sistema operativo integrar serie mejora .	Ciencia
Haaland marcar gol 100 empate City Erling Haaland marcar gol 100 Manchester City . delantero comparado androide , más número ser historia puro . noruego poner adelante equipo Arsenal , quedar 10 jugador , también inspirar empate 2-2 último minuto , John Stones encargar sentenciar .	Deportes
rendimiento Cetes tocar nivel más bajo enero rendimiento Cetes 28 día tener tasa más bajo enero pasado expectativa Banxico hacer más recort tasa referencia .	Economia
AMLO , México consolidar principal socio EU administración presidente Andrés Manuel López Obrador ( AMLO ) , primero vez historia , México convertir consolidar principal socio comercial Estados Unidos , mayor potencia económico mundo . embargo , decir especialista , futuro cercano aún quedar reto importante , ejemplo , definir relación gigante mundial , China , revisión T-MEC , instrumento potenciar relación .	Economía
Nadal volver competir liderar España final Copa Davis París . leyenda tenis Rafael Nadal , junto número tres mundial , Carlos Alcaraz , liderar España Final 8 Copa Davis , anunciar equipo capitaneado David Ferrer torneo disputar 19 24 noviembre , Málaga .	Deportes
Instituciones crédito incertidumbre Reforma Judicial , decir Moody’s pequeño mediano empresa enfrentar desaceleración crédito dar falta certeza jurídico institución financiero no bancario .	Economia
gobierno Sheinbaum necesitar nuevo política atraer inversión consumado desaparición proméxico , esfuerzo atraer inversión extranjero dividir . especialista cuestionar ente líder poder lograr él aún más .	Economia
México expropia minero Calica ; empresa estadunidense impugnacer firma estadunidense Vulcan Materials anunciar ir impugnar legalmente decisión gobierno mexicano , anunciado lunes noche , expropiar terreno mina Calica Quintana Roo .	Economía
escritura manual código tener día contado , vaticinar CEO NVIDIA Jensen Huang explicar 32.000 ingeniero software estar acompañado 100 vez más asistente digital , 24 hora día , 7 día semana .	Ciencia
Condusef alertar suplantación identidad 24 financiera Veinticuatro institución debidamente constituido haber reportar suplantación identidad cometer fraude usuario .	Economia
Bravos vencer Mets acercar comodín Atlanta . Bravos Atlanta hacer tarea lucha alcanzar boleto comodín postemporada Grandes Ligas . ganar 5-1 Mets Nueva York , quedar victoria conseguir meta .	Deportes
Javier Aranda Luna : Kundera : novela desafío rebeldir 8 diciembre 1968 , año recurrente historia mundo , cuatro amigo embarcar expedición extraordinario Praga .	Cultura
cuadrilátero , aguerrido ritual cautivar público medio crecimiento mediático industria entretenimiento , lucha libre mexicano mantener identidad popular cercanía afición , integrado profesionistas , trabajador , niño incluso extranjero complementar escenario espectáculo mezclar deporte , drama cultura .	Deportes
Leyendas pancracio regresar Coliseo Día nacional luchador hombre , ocasión mujer , máscara subir ring arena Coliseo , afición ovacionar , no importar ser rudo técnico , saber estar cuadrilátero arriesgar vida medio espectáculo más vistoso , folclórico polémico deporte : lucha libre . Místico , Octagón Atlantis , leyenda disciplina , ser ayer representante histórico función motivo Día nacional luchador lucha libre .	Deportes
papel economía bienestar gobierno moderno economía bienestar priorizar salud felicidad persona , colocar valor nivel , incluso encima , indicador económico tradicional PIB .	Economia
cet dos año reducir rendimiento dígito , anticipar recorte Banxico plazo Cetes reducir ganancia , plazo dos año ofrecer tasa más bajo 9.92% , espera Banxico hacer nuevo recorte .	Economia
Jaime Munguía regresar grande   ganar nocaut Jaime Munguía regresar ring plan grande . duro pelea canadiense Erik Bazinyan , Glendale , Arizona , pugilista mexicano conseguir victoria vía nocaut décimo asalto , luego poderoso gancho mano izquierdo ocasionar derrumbe rival . Bazinyan intentar parar él , recibir cuenta réferi , no encontrar fuerza pierna aceptar derrota . combate dejar mano tijuanense título plata peso supermediano CMB . “ ser pelea fuerte , pesado , momento Bazinyan lastimar . tener ir abriéndolo poco poco . ahora , querer mejor pelea . siguiente año gustar enfrentar Caleb Plant Édgar Berlanga ” , declarar Munguía , no pelear derrota tapatío Saúl Canelo Álvarez .	Deportes
AMLO buscar convertir CFE Telecom empresa público iniciativa reforma querer CFE TEIT ser principal compañía proveer internet país , respecto competidor , cambiar estatu estatal público .	Ciencia
Telmex suspender atención queja Centros servicio Culiacán Sindicato Telefonistas decir debido enfrentamiento armado entidad , decidir no abrir tienda , centro trabajo resguardar integridad técnico .	Ciencia
México perder penales leyenda FIFA plantel repleto figura época , equipo leyenda FIFA Monterrey protagonizar partido exhibición congregar mil persona estadio BBVA , actual casa Rayados sed México Copa Mundo 2026 . Andrea pir él , Dwayne Rosario Youri Djorkaeff marcar internacional , ex seleccionado tricolor Luis Hernández , Miguel Layún Jorge Campos lograr empate tres . ya penales , representante FIFA imponer 5-4 . dar inactividad participante retiro profesional , organizador ajustar dimensión terreno juego . leyenda FIFA estar arquero Gianluigi Buffon , Alessandro Piero , Didier Drogba , Carles Puyol , Xavi Hernández Diego Forlán . México destacar Oribe Peralta , Luis Hernádez , Jorge Campos , Guillermo Franco , Paul Aguilar técnico Bora Milutinovic .	Deportes
León Bendesky : ejemplo escritor inglés H.G. Wells apuntar Historia supervivencia mismo depender carrera educación catástrofe . idea ser adecuar reflexionar cuestión hoy ser relevante persistente violencia haber mundo , bien , incapacidad humanidad contener degradación medio ambiente .	Economía
Mexicana presentar avión Embraer sumar flota 2025 Zumpango , Méx . , fin consolidar él industria transporte aéreo nacional , Mexicana Aviación , aerolínea Estado mexicano , presentar avión Embraer E195-E2 , modelo adquirir 20 unidad aerolínea empezar recibir partir mayo 2025 .	Economía
"OpenAI lanzar nuevo serie modelo IA capacidad "" razonamiento "" modelo conocido internamente strawberry tener alto calificación prueba matemática codificación . empresa reconocer aún poder dar respuesta limitado ."	Ciencia
Cetes reducir rendimiento previo decisión Banxico próximo semana , Banco México ( Banxico ) dar conocer decisión política monetario Cetes disminuir rendimiento plazo .	Economia
Concentra manufactura flujo inversión extranjero : enero 2023 septiembre 2024 , sector privado realizar 575 anuncio inversión México más 170 mil 644 millón dólares , revelar dato actualizado Secretaría Economía ( SE ) .	Economía
Desequilibrio balanza comercial acumular 10 mil 438 mdd agosto balanza comercial país observar agosto 2024 déficit 4 mil 868 millón dólares , dinamismo explicar retroceso ciento exportación frente igual periodo año anterior , informar Instituto Nacional Estadística Geografía ( Inegi ) .	Economía
Yanquis , ya clasificado playoff , caer 9-4 Pittsburgh Nueva York . , Yanquis , ya clasificado postemporada Grandes Ligas , caer ayer 9-4 Piratas Pittsburgh , pegar cinco jonrones , incluir cuatro frente novato dominicano Luis Gil . resultado , retrasar equipo Nueva York conseguir ventaja casa playoff Liga Americana .	Deportes
Banxico proyectar nearshoring México 2026 2030 encuesta Banco México , 41.3% empresa consultado estimar mayor beneficio proceso relocalización dar periodo .	Economia
Retrasos ferrocarril México-EU afectar suministro agrícola Chicago . retraso transporte ferroviario estar perturbar comercio exportación Estados Unidos México cadena suministro agrícola pleno cosecha otoño boreal , denunciar ayer organización agrario .	Economía
Volkswagen negociar sindicato después explosivo anuncio Volkswagen poder cerrar fábrica Alemania primero vez , dirección empresa sindicato iniciar tenso conversación nuevo acuerdo salarial . empresa haber subrayar repetidamente coste ser excesivo margen beneficio demasiado bajo , especialmente marca principal .	Economía
Filis coronar Este Nacional ; terminar dominio Bravos Filadelfia . Filis Filadelfia ganar División Este Liga Nacional primero vez 2011 asegurar título victoria 6-2 Cachorros Chicago . además , terminar racha Bravos Atlanta coronar él seis temporada consecutivo división .	Deportes
IFT prever publicar nuevo medida regulatoria América Móvil noviembre regulador tener obligación revisar dos año medida regulatoria compañía controlado Carlos Slim verificar haber generar competencia telecomunicación .	Ciencia
Telmex suspender Sebog servicio resguardo información impago Triara , división Centros Datos Telmex , suspender servicio resguardo información Gobernación impago 63.7 millón pesos .	Ciencia
desempleo Alemania aumentar más previsto Berlín . número desempleado Alemania aumentar más previsto septiembre , nuevo señal reto enfrentar mayor economía Europa .	Economía
Título Copa Campeones motivo   América duelo Pumas : Dávila reciente obtención título Copa Campeones ser factor motivar América cara clásico capitalino domingo Pumas , asegurar delantero Víctor Dávila , además indicar más allá tratar derrotar acérrimo rival , equi-po buscar toda costa triun-fo ubicar él zona liguilla .	Deportes
Recauda SAT seis año 3.5 billón pesos sexenio estar concluir , Servicio Administración Tributaria ( SAT ) recaudar 3.5 billón pesos auditoría promoción cumplimiento , representar 2.3 billón pesos más sexenio anterior crecimiento real 120.2 ciento agosto año .	Economía
Sofipos ver oportunidad figura , pesar migración bancario Asociación Mexicana Sofipos ( AMS ) considerar nuevo regulación , institución poder seguir crecer ayuda regulación tecnología .	Economia
Dallas , esperanza frustración Lamar Jackson Baltimore resistir intento remontado Dallas , llegar tarde . dos anotación estelar mariscal campo , Cuervos derrotar 28-25 Vaqueros encuentro marcado suspenso minuto final .	Deportes
Openbank lanza lista espera cliente mexicano Openbank México abrir sitio web lista espera usuario querer acceder oferta nuevo banco digital .	Economia
Dubois noquea Joshua retener cetro pesado Londres . Daniel Dubois retener título pesado Federación Internacional Boxeo ( FIB ) noquear quinto asalto ex bicampeón Anthony Joshua , primero defensa cinturón realizado estadio Wembley	Deportes
Janet Yellen oponer reducir requisito capital banco secretaria Tesoro Estados Unidos pedir seguir trabajar sistema financiero ser resistente tiempo turbulencia .	Economia
López Obrador inaugurar Veracruz Centro Cultural Leyes Reforma Veracruz , Ver . , presidente Andrés Manuel López Obrador inaugurar ayer puerto Veracruz Centro Cultural Leyes Reforma , realizar recorrido recién rehabilitado Casa Benito Juárez , espacio abrir puerta visitante partir noviembre , buscar generar reflexión ley más importante publicado siglo xix .	Cultura
entregar Tolita María Figueroa Medalla Oro Bellas Artes 2023 teatro hermana Tolita María Figueroa ser distinguir martes Medalla Oro Bellas Artes 2023 disciplina teatro . reconocimiento celebrar destacado trayectoria prolífico obra ámbito vestuario escenografía , campo “ haber dejar huella imborrable más tres década ” .	Cultura
Muñeca Lele otomí representar principal fuente empleo Santiago Metztititlán Pachuca , Hgo . , Artesanas indígena otomí Santiago Metztititlán , municipio Amealco Bonfil , estado Querétaro , generación haber elaborar tradicional muñeca Lele , nacer deseo niña localidad jugar ser mamá .	Cultura
TikTok Departamento Justicia enfrentar tribunal EU abogado TikTok enfrentar Departamento Justicia tribunal Washington destino ley poder prohibir aplicación vídeo corto .	Ciencia
PlayStation lanzar edición limitado aspecto noventero consola evocar aspecto primero equipo , lanzado Sony 1994 , formar parte celebración 30 año .	Ciencia
Tuzos salir crisis ; derrotar Puebla visita Pachuca reordenar pieza rompecabeza . victoria fecha anterior , Tuzos volver ganar Liga Mx imponer él 3-2 Puebla estadio Cuauhtémoc . mucho tener ver debilidad defensivo Franja , más contundencia delantero Salomón Rondón Nelson Deossa , ser figura ataque .	Deportes
Silvia Ribeiro * : Ayotzinapa , impunidad olvido saber paradero , justicia tortuoso camino encubrimiento impunidad , cumplir 26 septiembre 10 año desaparición forzado 43 estudiante escuela normal Raúl Isidro Burgos Ayotzinapa asesinato seis persona , tres estudiant .	Economía
Gasolina Magna ir segundo semana subsidio semana 14 20 septiembre , consumidor pagar 6.1752 pesos Impuesto Especial Producción Servicios ( IEPS ) litro gasolina regular .	Economia
CFE Telecom perfilar nuevo CEO impulsar proyecto internet dos fuente conocimiento tema , interior compañía haber poner mesa nombre Emiliano Calderón Mercado ser nuevo CEO estatal telecomunicación .	Ciencia
Empresas EU reactivar anuncio inversión ; confiar Sheinbaum detener anuncio importante inversión reforma judicial , American Society of Mexico informar próximo fecha retomar , cautela .	Economia
Hermann Bellinghausen : Stravinski vendedora disco segundo parte     año 40 siglo xx Ciudad México deber ser tranquilo , optimista , promisoria . cielo azul limpio , sorprender , ser normal siempre ciudad lago , finalmente derrotado , futuro . allí hacer familia , venido menos , parecido salir película Soler , Pedro Infante Joaquín Pardavé . conformar seis varón cuatro hembra . tono época , primero ser debilidad madre , derecho hombre , sagrado . contar alcohólico , vividor , perezoso , odiar ser mexicano , menor edad único estudiar carrera . tener obligación aportar casa , querer pasar dificultad financiero ; siempre estar “ arrancado ” . tampoco mamá gustar trabajo , papá hacer mala ganar , no ver hora ir caza escuchar ópera música clásico amigo . pronto comenzar recibir pensión burócrata .	Cultura
Ten Hag unir crítica saturación partido Londres . técnico neerlandés Manchester United , Erik ten Hag , criticar sobrecarga partido , ya considerar “ casi inevitable ” lesión grave sufrir futbolista , ocurrir pasado fin semana arquero alemán Marc-André Ter Stegen ( Barcelona ) mediocampista español Rodri ( Manchester City ) .	Deportes
Caso FTX : rol Caroline Ellison fraude pasar 2 año presar exdirectora Alameda Research , fondo cobertura personal Bankman-Fried , también deber pagar multa 11.000 mdd .	Ciencia
BBVA advertir reforma Poder Judicial socava Estado derecho análisis banco considerar perspectiva crecimiento económico México también poder deteriorar él .	Economia
Salir bache natación ser imposible modelo actual : Liliana Ibáñez sistema deportivo mexicano mantener obsoleto lucha ego autoridad no detener , ser imposible natación salir bache encontrar hacer década . Liliana Ibáñez , más experimentado disciplina , levantar voz profundo crisis prevalecer país .	Deportes
ó : Instrucciones salir agua desmontar mito Ofelia mirada feminista “ Ser no ser ” , escuchar escena . famoso frase no pronuncia Hamlet , mujer cuestionar opción ser morir , dormir tal vez soñar . tratar propuesta escénico Ó : Instrucciones salir agua , conjugar teatro físico danza repensar personaje shakesperiano Ofelia mirada moderno feminista . María Fernanda Baez interpretar unipersonal iniciar temporada teatro Milagro .	Cultura
Alerta sísmico llegar teléfono próximo 19 septiembre : IFT Telcel , AT&amp;T , Telefónica Bait comenzar enviar notificación emergencia   , huracán inundación celular .	Ciencia
mercado tableta buscar conquistar diseñador , creativo melómanos Lenovo Huawei presentar nuevo tableta mercado mexicano coincidencia apostar conquistar creativo .	Ciencia
ser poco probable México perder grado inversión : Moody's agencia señalar mayor déficit fiscal , absorber deuda Pemex bajo crecimiento sí poder impactar calidad crediticio .	Economia
¿ abrir banco 1 octubre ? decir calendario CNBV 1 octubre , Claudia Sheinbaum tomar posesión primero presidenta México , implicar suceso trascendencia nacional , mayoría empleado descansar .	Economia
aumentar ingreso divisa turístico ; elevar llegada viajero ser gran reto indicador marcar potencialidad turístico nación ser captación divisa viajero internacional , afirmar Miguel Torruco , titular Secretara Turismo ( Sectur ) . Medido forma , largo sexenio , país haber incrementar presencia nivel mundial , mostrar dato oficial .	Economía
Coparmex advertir reforma judicial afectar proyecto clave economía organismo empresarial lamentar aprobación Senado República , señalar ser decisión no tomar cuenta diferente voz .	Economia
auditoría dar ingreso 3.5 billón pesos SAT recurso , 1426 billón pesos obtener auditoría grande contribuyente , informar fisco .	Economia
José Antonio Rojas Nieto : economía Estados Unidos : cuarto apreciadísimo doctoro     Edith Klimovsky Barón , profesora distinguido UAM Azcapotzalco , presentar reciente congreso Economía Matemática Tlaxcala ponencia plantear Edith dixit – eje determinar mostrar relación salario beneficio . relación fundamental Clásicos , evidente Marx , duda –  pesar – Neoclásicos .	Economía
experto : mayor desastre ecológico Riviera Maya mina Sac-Tun , antes conocido Calica , propiedad Vulcan Materials ser “ mayor desastre ecológico ” Riviera Maya , más tres década extraer material exportar barco Estados Unidos , acuerdo especialista gobierno mexicano .	Economía
Tequila , mira China Qionglai , Chengdú . , medio montaña alberguir sitio más grande observación luciérnaga Asia , estar crecer atractivo mexicano parte comercialización destilado . qionglai – condado 2 mil 300 año historia remitir antiguo Ruta Seda – buscar incluir tequila proyecto erigir meca bebida espirituosa ; incluso importar jugo agave producción local .	Economía
México buscar ser máximo exponente Homeless Cup Luego largo viaje Corea Sur , selección futbol calle cumplir objetivo estar final Homeless World Cup estar pasó convertir él máximo exponente torneo .	Deportes
Vilma Fuentes : Buenos día , Jacques ( 1936-2024 ) Jacques Bellefroid morir mañana 20 septiembre 2024 . escribir frase poco más 24 hora después suceder escándalo indecible . fecha confundir día no cesar girar ruleta hora , repitar infinito , , siempre siempre . muerte , Jacques , vida , amor . no comprendo poder seguir viva estar muerto , menos ser decir . decir Tania ayer inicio tarde asoleado , aquí , hospital Charles Foix , afuera París , estar hospitalizado seguir vivo ya haber ir aquí no saber . ¿ poder encontrarte nuevo infinito inmensidad haber ir ? Búscame , pedir busques . sólo poder encontrar yo laberinto túnel pasaje , muro puerta , señal sentido .	Cultura
“ quedar corto hablar significar Jornada México ” hacer poco más 40 año “ haber más periodismo , decir él manera , además grande diario , estar Figaro , Cine Mundial , Redondel , segundo Ovaciones , últimas Noticias , Extra . hoy ser cochinada , ser difusor noticia no noticia ; estar lado . panorama , importante ser existir Jornada , dar lugar lector ” .	Cultura
Moody's prever reforma judicial debilitar calidad crediticia México cambio sistema judicial perjudicarir futuro inversión nearshoring , decir agencia calificadoro .	Economia
“ haber luchar mundo diferente ” Medallas Bellas Artes 2023 2024 ámbito Arquitectura Patrimonio ser entregar ayer Enrique Ortiz , Sara Topelson , Gabriel Mérigo Salvador Aceves .	Cultura
Joseph E. Stiglitz , Kevin P. Gallagher , Martín Guzmán Marilou Uy Especial Jornada : FMI deber poner fin destructivo recargo nar	Economía
ser longevo cuadrilátero requerir mentalidad fuerza : Felino longevidad poder ser grande bondad lucha libre , siempre “ cuides tu cuerpo aprenda escuchar él ” , asegurar Felino , 60 año trayectoria cuatro década seguir cautivar aficionado función impresionante llave espectacular acrobacia .	Deportes
YouTube lanzar nuevo herramienta ayudarte emergencia médico través división Health , plataforma videos colaborar institución certificada , Cruz Roja , dar información situación urgencia .	Ciencia
ocupar México séptimo lugar adopción inteligencia artificial México ser país adoptante inteligencia artificial ( IA ) , índice 46.85 punto , colocar séptimo posición 19 encontrar incorporar tecnología , informar Comisión Económica América Latina Caribe ( Cepal ) .	Economía
"banquero esperar ley secundaria reforma judicial dar certidumbre aprobación reforma Poder Judicial ,   banquero esperar ley secundario afinar detalle permitir reforma "" exitoso "" ."	Economia
sexenio ser repatriar 14 mil 48 pieza , destacar mañanera último conferencia mañanero presidencial , funcionario presentar balance acción recuperación memoria histórico preservación patrimonio cultural , destacar repatriación 14 mil 48 pieza extranjero .	Cultura
austeridad selectivo predominar gobierno AMLO más recorte gasto oneroso generar ahorro , gasto público llegar nivel récord , obedecer prioridad obligación gobierno cargo Andrés Manuel López Obrador .	Economia
Claudia Sheinbaum reunir empresario Estados Unidos octubre medio voz empresarial decir inversión haber detener reforma judicial , Marcelo Ebrard anunciar asistencia próximo presidenta México CEO Dialogue .	Economia
Carlos Fernández-Vega : México SA Ernesto Zedillo ser     seis depredador Estado instalado Pinos régimen neoliberal , igual gerente estirpe , dedicar entregar bien nación gran capital . bien sello sexenal ser ilegal “ rescate ” banca , vía Fobaproa , personaje ahora intentar reivindicar derecha autóctono ser más allá , siempre contra interés nacional .	Economía
OCDE ajustar baja previsión PIB México acuerdo organismo , economía mexicano crecer 1.4% año , 0.8% menos previsión anterior .	Economia
Confía sector empresarial remontar pronóstico crecimiento Consejo Coordinador Empresarial ( CCE ) confiar economía mexicano superar pronóstico crecimiento apuntar desaceleración .	Economía
Amazon lanzar nuevo bot ayudar crecer venta empresa dar conocer Amelia obtener dato venta inventario negocio estar plataforma .	Ciencia
crear diario personal IA WhatsApp inteligencia artificial WhatsApp , Meta AI , poder aprovechar él realizar simplificar tarea . aquí explicar crear diario personal	Ciencia
Intel , nuevo objeto deseo industria tech empresa pionera industria chip haber ser objeto nuevo rumor posible adquisición parte Qualcomm , así inversión firma capital .	Ciencia
“ conclusión proyecto Naturaleza Cultura ser prioridad gobierno entrante ” proyecto Chapultepec : Naturaleza Cultura no haber dar concluido . mantener prioritario próximo gobierno federal , afirmar subsecretaria Desarrollo Cultural Secretaría Cultura federal ( SC ) , Marina Núñez Bespalova .	Cultura
Lucía García rescatar Rayadas jugadora mayor jerarquía internacional , español Lucía García rescatar campeón Monterrey conseguir agónico empate 1-1 León estadio nou Camp . Rayadas , haber sufrir torneo Clausura 2024 Liga Mx Femenil , desplazar América tercer puesto 26 unidad después 12 jornada , tiempo Esmeraldas tener 12 punto .	Deportes
Elena Poniatowska : Grito madrugada 16 septiembre 1810 , “ Grito Independencia ” , historia dar cura Miguel Hidalgo Costilla pueblo Dolores , Guanajuato , rasgó cielo hacer estallar movimiento Independencia .	Cultura
TikTok vs EU : historia antaño no tener fin claro prohibición llegar enero 2025 , empresa interponer demanda evitar restricción , candidato presidencia tampoco querer bloquear .	Ciencia
Microsoft confiar México ; invertir 1.300 mdd ampliar alcance IA CEO compañía , Satya Nadella ,   destacar capital ser mejorar capacidad nube IA región .	Ciencia
Uber Didi operar sitio AICM , pese restricción usuario continuar pedir servicio taxi aplicación Uber apuntar continuar operar regularidad .	Ciencia
alistar inauguración Museo Vivo Muralismo día final gobierno presidente Andrés Manuel López Obrador , concluir obra restauración , rehabilitación mantenimiento Museo Vivo Muralismo ( MVM ) , prever inaugurar semana edificio histórico Secretaría Educación Pública ( SEP ) , reconocido patrimonio mundial Organización Naciones Unidas Educación , Ciencia Cultura ( Unesco ) .	Economía
Cruz Azul , líder arrollador ; remontar imponer Pachuca Hidalgo líder Cruz Azul aparecer tarde estadio Hidalgo . más 40 minuto jugar equipo errático , irreconocible , ser abajo dos gol marcador . vez funcionar plan partido , grado dificultad siempre expulsión incluido Sergio Damián Barreto fuerte entrada Luis Romo , Máquina venir atrás ganar 4-2 mantener él cima Liga Mx .	Deportes
IFT pedir 1.680 mdp presupuesto pese reforma eliminar autónomo regulador asegurar partida solicitar Hacienda ser ser aprobar año incluso más bajo tomar cuenta inflación .	Ciencia
Mira Murati , CTO OpenAI , dejar empresa 2024 haber ser año complicado startup Inteligencia Artificial , ejecutivo fundador haber renunciar .	Ciencia
México ratifico hegemonía Homeless Cup Corea Sur México ratificar hegemonía Homeless World Cup llevada cabo Seúl , Corea Sur , consagrar máximo ganador torneo . selección varonil ganar 6-5 Inglaterra último momento evitar penal , obtener quinto título , equipo femenil conseguir noveno corona luego vencer Rumania 5-2 día ayer .	Deportes
ONU formular siete recomendación regular IA ONU crear año pasado órgano consultivo 39 miembro abordar problema regulación internacional IA .	Ciencia
Rappi considerar debutar Bolsa Nueva York año Rappi operar nueve país región ser considerar unicornio tecnológico valoración superar 5.000 millón dólares .	Ciencia
Confirma Sheinbaum salido Gabriel Yorio Subsecretaría Hacienda subsecretario Hacienda , Gabriel Yorio González , no repetir cargo próximo sexenio , así confirmar próximo titular Ejecutivo federal .	Economía
Calica no haber expropiación , aplicar defensa territorio : AMLO “ no haber expropiación ” banco material explotar gigante minero Vulcan Materials costa Quintana Roo , aseverar presidente Andrés Manuel López Obrador .	Economía
ir conciencia tranquilo arrepentimiento : Ana Guevara Convencida cumplir deber , pesar crítica afrontar llegada cargo 2018 , Ana Guevara asegurar ayer dejar dirección Comisión Nacional Cultura Física Deporte ( Conade ) arrepentimiento , conciencia tranquilo seguro no gozar sobreprotección administración .	Deportes
Caliente pasar anunciar apuesta transmitir Champions League compañía haber entrar ‘ guerra streaming deportivo ’ captar parte nicho mercado consolidar principal negocio : apuesta .	Ciencia
TelevisaUnivision nombrar nuevo CEO exdirectivo Google tratar Daniel Alegre , sustitución Wade Davis ,   contar amplio experiencia empresa tecnología trabajar comunidad hispano EU , México América Latina .	Ciencia
Fátima Herrera , miedo ,   hacer historia ring París 2024 surgimiento referente deporte mujer comenzar forjar nuevo talento . inspira-da proeza Jackie Nava Ana María Guerrera Torres , Fátima Herrera pelear llegar París 2024 , hacer historia convertir él primero boxeadora mexicano conseguir victoria Juegos Olímpicos .	Deportes
denunciar Visa monopolio Estados Unidos Departamento Justicia Estados Unidos buscar denunciar empresa   monopolio mercado tarjeta débito , acuerdo reporte Blomberg .	Economia
Trump amagar arancel 100% auto entrar frontera México candidato presidencial decir único manera librar cuota ser querer construir planta Estados Unidos .	Economia
eliminación subsidio gasolina impedir baja precio medida disminución estímulo fiscal obedecer más necesidad incrementar recaudación impuesto reducir déficit fiscal , considerar especialista .	Economia
combate tradicional , acto resistencia espectacularidad wrestling estadunidense década años 50 60 lucha libre mexicano ser célebre combate ras lona , uso llave máscara multicolor convertir patrimonio cultural . 80 , influencia wrestling estadunidense , caracterizado espectacularidad uso múltiple objeto – mesa fuego , silla escalera – , impactar forma aficionado concebir deporte .	Deportes
China presentar medida relajación monetario reactivar economía Banco Popular China recortar tipo interés operación doble siete día 0.2 punto porcentual , 1.5% .	Economia
Gasto bolsillo salud pegar familia gasto médico inesperado México poder representar golpe bolsillo ciudadano , alcanzar costo medio nacional 117 mil 766 pesos 2023 , estimar Asociación Mexicana Instituciones Seguros ( AMIS ) .	Economía
Amazon agregar PayPal método pago pedido Comprar Prime nuevo opción estar disponible usuario realizar compra sitios web tercero , membresía Prime .	Ciencia
OpenAI creer junta seguridad capaz detener nuevo lanzamiento empresa buscar mejorar proceso protección , confianza transparencia medio búsqueda nuevo ronda financiación multimillonario .	Ciencia
Galardona Inbal tres grande artista tejer lienzo plástica mexicano ” ovación vítor , escultora Geles Cabrera ( 1926 ) pintor Arturo Estrada ( 1925 ) Guillermo Monroy ( 1924 ) recibir Medalla Bellas Artes Oro Artes Visuales 2023 2024 , ceremonia “ histórico ” , efectuado ayer sala Manuel M. Ponce Palacio Bellas Artes , encabezado Lucina Jiménez , titular Instituto Nacional Bellas Artes Literatura ( Inbal ) .	Cultura
Murió Fredric Jameson , crítico capitalismo   referente marxismo EU Fredric Jameson ( 1934 ) , crítico , teórico catedrático literario estadunidense , fallecer domingo 90 año , informar editorial Verso Libros red social .	Cultura
Infonavit manejar 2.4 billón pesos activo : Carlos Martínez fondo instituto haber aumentar aumento salarial , mayor aportación patronal , fiscalización empresa , programa regularización crédito .	Economia
identidad digital industria financiero : defensa armar biometría criptografía reducir riesgo suplantación identidad , también abrir nuevo riesgo no hacer adecuadamente .	Ciencia
Altán Redes confiar gobierno Sheinbaum robustecer conectividad Carlos Lerma , CEO Altán , decir estar “ positivo venir próximo año ” conectividad , debido provisión internet ser eje principal Claudia Sheinbaum .	Ciencia
Cifras verde * llave programa planeación ciudad inteligente verde , bicicleta haber recuperar relevancia proyecto urbano .	Economía
Reserva Federal EU ya no ser referente política monetario global banco central país realizar serie movimiento tasa interés semana , encabezado Reserva Federal Estados Unidos ( Fed ) , miércoles recortar tasa referencia primero vez 2020 .	Economía
Ciudades globo vivir burbujo inmobiliaria : estudio Miami , Tokio Zúrich encabezar lista ciudad mayor riesgo burbuja inmobiliario nivel mundial , debido elevado amenaza mercado vivienda , revelar UBS Global Real Estate Bubble Index 2024 .	Economía
YouTube presentar IA hacer video ganar ‘ más ’ dinero empresa llevar cabo Made on YouTube evento también señalar número creador obtener mayor parte ingreso venir tv .	Ciencia
Pemex enviar combustible Refinería Olmeca India Petróleos Mexicanos ( Pemex ) enviar mes primero cargamento combustible nuevo refinería Olmeca India , señal progreso después múltiple retraso costo espiral , dato embarque fuente industria .	Economía
UNAM celebrar 60 año fundación Archivo Histórico Universidad Nacional Autónoma México ( UNAM ) celebrar ayer 60 aniversario fundación Archivo Histórico ; además , inaugurar exposición Archivo Histórico UNAM , ayer hoy .	Cultura
Gustavo Gordillo / III : Justicia , anillo , poder haber mayoría , tener haber minoría . ser minoría , existencia político , constituir régimen mayoría .	Economía
Cae dupla Zverev-Alcaraz dupla Carlos Alcaraz-Alexander Zverev caer pareja estadunidense formado Taylor Fritz Ben Shelton , 7-6 ( 7/5 ) 6-4 , dejar marcador 2-2 final primero jornada Laver Cup , disputar Berlín . impulsado Roger Federer 2017 , competencia – exhibición inspirado Ryder Cup golf llamado así homenaje jugador australiano Rod Laver – enfrentar seis jugador Europa número representante resto mundo .	Deportes
Tercer cuadrangular   mexicano Jonathan   Aranda Tampa Bay St . Petersburgo . , mexicano Jonathan Aranda pegar cuadrangular tercer partido consecutivo Rays Tampa Bay , vencer 4-3 Azulejos completar barrida serie tres juego .	Deportes
"Yellen considerar "" señal mucho positivo "" recorte tasa Fed medida "" reflejar confianza parte Fed inflación ceder estar camino meta 2% ( anual ) "" , expresar secretaria Tesoro EU ."	Economia
ser Antonio Martínez Dagnino , jefe SAT gobierno Sheinbaum Antonio Martínez Dagnino llegar jefatura SAT octubre 2022 , luego Raquel Buenrostro pasar tomar liderazgo Secretaría Economía .	Economia
Jefes continuar invicto ; superar 22-17 Halcones Atlanta . Patrick Mahomes lanzar par pase anotación defensivo Kansas City realizar par defensa tardía mantener Jefes invicto vencer 22-17 Halcones Atlanta .	Deportes
Amazon Prime MGM Studios unir MPA empresa entretenimiento unir Netflix Paramount Pictures .	Ciencia
inaugurar Museo Vivo Muralismo pasado , cambio gobierno vivir “ ruptura ” . “ saber ” , decir presidenta electa , Claudia Sheinbaum , sonrisa . ocasión ser inauguración Museo Vivo Muralismo ( MVM ) , edificio histórico Secretaría Educación Pública ( SEP ) .	Cultura
México impugnacer fallo determinar pago 37 mdd Odyssey Marine Exploration empresa estadounidense ganar arbitraje internacional México , considerar Semarnat negar arbitrariamente permiso proyecto minero marino Baja California Sur .	Economia
Secretario Arte Cultura Morena rendir informe actividad Secretario Arte Cultura Comité Ejecutivo Nacional ( CEN ) Morena , Tomás Pliego Calvo , indicar medio participación 22 comisión estatal arte cultura , artista , creador , promotor , gestor cultural , colectivo cooperativo , organizado partir plan acción secretaría , “ realizar tarea actividad defensa Cuarta Transformación ( 4 T ) , promover cultura incluyente equitativo luchar lucha clasismo , racismo , machismo fascismo ” .	Cultura
Pumas femenil dejar escapar tres punto cu pese generar oportunidad gol , Pumas no lograr pa-sar empate 0-0 Querétaro , dejar escapar valioso punto permitir afianzar él primero lugar clasificación general torneo Apertura 2024 Liga Mx Femenil .	Deportes
Banxico mantener prudencia cerrar año tasa 10% analista considerar mensaje banco central ser más laxo decisión agosto esperar haber dos recorte más 25 punto base .	Economia
eu prohibir software hardwarir chino vehículo Washington . Departamento Comercio Estados Unidos proponer lunes prohibir software hardware chino vehículo conectado autónomo carretera país debido preocupaciones seguridad nacional , decir fuente Reuters .	Economía
Pablo Espinosa : creatura habitar Bellas Artes luz distinto hora devora .	Cultura
"EU pedir "" implementación riguroso "" plan certificación aguacate México venta aguacate mexicano Estados Unidos haber disparar 48% 2019 , alcanzar valor más 3.000 millón dólares año pasado ."	Economia
¿ dar Apple iphone abonar compra nuevo ? programa Trade In recibir equipo iphone 2020 15 Pro Max , bonificación máximo 20.000 pesos .	Ciencia
Angélica Azuara recomendar Jornada trinchera : puesto periódico Angélica Azuara , puesto periódico trabajar hacer 15 año ser también trinchera , haber tocar “ evadir recibir dardo censura sexenio anterior , así ment panista cerrado hoy día ” .	Cultura
CNBV buscar regular report ciberseguridad regulador buscar empresa ofrecer servicio financiero der homologar criterio reportar haber ser víctima ataque cibernético .	Economia
caso Caliente TV : anunciar apuesta transmitir Champions League compañía haber entrar ‘ guerra streaming deportivo ’ captar parte nicho mercado consolidar principal negocio : apuesta .	Ciencia
ser innecesario reforma fiscal siguiente sexenio presidente Andrés Manuel López Obrador asegurar no ser necesario reforma fiscal futuro mantener fórmula combate corrupción política austeridad republicano .	Economía
Real Madrid sacar apurado victoria Alavés Madrid . Real Madrid ser luz noche . ofrecer sábado versión más contundente visita Español Santiago Bernabéu , equipo blanco revelar costado más vulnerable apurado victoria 3-2 Alavés , cumplir año derrota Liga España .	Deportes
Marlene Santos Alejo : Balance jornada increíble parecer ,     equipo milloneta favorito Liga Mx sufrir perder estribo . América Monterrey empatar duras pena , Cruz Azul ganar mínimo ventaja Chivas sólo conseguir sumar frente colero … emoción regalar fecha doble , dar nota quejoso André Jardine , timonel amarillo , Ivar Sisniega , titular Federación Mexicana Futbol , preocupado bajo entrada Estados Unidos , pedir “ transmitir mensaje positivo apoyo selección ” .	Deportes
Charlyn Corral lograr doblete mantener invicto Pachuca ; empatar 3-3 Chivas duelo vertiginoso , Charlyn Corral firmar doblete Pachuca igualar 3-3 Chivas mantener invicto primero puesto , jornada once torneo Clausura 2024 Liga Mx Femenil . Tuzas sumar 29 unidad estar espera duelo Tigres Tijuana confirmar liderato , tapatía ubicar quinto puesto 20 unidad temporada más irregular .	Deportes
Mexicanos gastar 12% más bebida energético Datos Kantar mostrar último año haber aumentar tanto número litro comprado precio tipo bebida .	Economia
sequía impactar precio peso carne r : Banxico Banco México destacar sequía provocar productor carne sacrificar ganado antes tiempo no perder peso ; llegar provocar inflación mediano plazo .	Economia
Mexico necesitar política industrial acordar economía actual : IMCO centro investigación apuntar último 20 año , valor agregado producción exportación manufacturero haber estancar .	Economia
IA generativo transformar operación ingreso empresarial uso IA generativo haber crecer sector , impulsar innovación facilitar nuevo forma operar organización .	Ciencia
Ohtani desata euforio   prensa japonés proeza Shohei Ohtani , convertir primero pelotero Grandes Ligas 50 jonrón 50 base robado temporada , ser celebrar edición extra periódico aficio-nado leyerar camino trabajo viernes Japón .	Deportes
orlar Delgado Selley : Balance desafío haber llegar final primero administración federal 4t. ser posible hacer balance ponderado funcionamiento economía . balance necesario , además , establecer base plantear desafío enfrentar nuevo administración periodo gobierno , particularmente , primero año . supuesto , primero cuestión ser sexenio AMLO economía mexicano enfrentar crisis derivado covid , afectar país , diferente medida .	Economía
déficit fiscal México crecer 54% agosto superar billón pesos Secretaría Hacienda Crédito Público destacar Requerimientos Financieros Sector Público sumar 1109 billón pesos .	Economia
netflix Prime Video Amazon liderar queja streaming agosto año , ambos empresa recibir inconformidad parte usuario cobro indebido alteración precio , asegurar Profeco Expansión través transparencia .	Ciencia
BBVA mantener confianza México transición presidencial país seguir ser atractivo largo plazo gracias estructura costo apalancamiento comparación Estados Unidos , decir Onur Genç , consejero delegado BBVA .	Economia
¿ servicio cliente manos IA ser mejor humano ? más mitad profesional servicio cliente ya ocupar software impulsado IA esperar continuar crecer .	Ciencia
inconformidad justicia mexicano , acreedor TV Azteca iniciar proceso Secretaría Economía informar disputa internacional México , impago bono tv Azteca , acumular costo 150.000 dólares concepto honorario CIADI .	Ciencia
tomar cuenta semana iniciar dar conocer report , inflación , venta menudeo , indicador actividad económico , balanza comercial anuncio política monetario , .	Economía
Vendaval americanista ; Águilas golean Rayadas 4-2 Monterrey tardar más 70 minuto meter él partido . finalmente despertar , América ya golear tener prácticamente triunfo bolsa . 4-2 sentenciar exhibición más desconcertante paupérrima Rayadas campaña . abucheo afición , más rostro desencajado jugadora terreno juego , reflejar diferencia existir respecto Águilas .	Deportes
Inflación agroalimentario ir baja , aún haber producto incremento arriba 60% primero quincena septiembre tanto inflación general agroalimentaria presentar reducción significativo ; embargo , aún existir producto factor , clima estacionalidad , registrar incremento anual encima 60 ciento anual caso fresa cebolla .	Economía
Instagram lanza contar adolescente control parental usuario menor 16 año sólo poder recibir mensaje ser etiquetar cuenta seguir ya estar conectado .	Ciencia
asegurar Guardianes descanso postemporado vencer 6-1 Rojos Cleveland . Guardianes Cleveland , campeón División Central Liga Americana , asegurar descanso primero ronda playoff vencer 6-1 Rojos Cincinnati . Lane Thomas pegar jonrón dos anotación empujar tres carrera Josh Naylor sumar par remolcada .	Deportes
SAT obtener 191.506 mdp eficiencia recaudatorio 2024 mayor eficiencia recaudatorio deber principalmente programa Cumplimiento Obligaciones , Vigilancia Profunda Cobranza Coactiva .	Economia
Banco Mundial logra récord 56.000 mdd inversión CFI ejercicio financiero finalizar julio 2025 , Banco Mundial buscar centrar esfuerzo infraestructura , particularmente carretera transporte .	Economia
Guía elegir mejor antivirus celular ataque teléfono inteligente vez ser más común aquí decir deber tener cuenta hora elegir mejor protección .	Ciencia
número súper rico disparar Estados Unidos China población China menos 100 millón dólares cuenta haber duplicar último 10 año .	Economia
Anuncios inversión México sumar 59.900 mdd primero nueve mes 2024 Secretaría Economía identificar 197 anuncio público enero septiembre . Estados Unidos encabezar anuncio .	Economia
Emilio Payán : Litógrafa Popular artista grabador Joel Rendón ( 1967 ) impresor Fernando Riquelme ( 1990 ) fundar hacer dos mes Litógrafa Popular , taller reunión , diálogo intercambio experiencia conservar tradición técnica México . proyecto rendir homenaje madre tierro considerar piedra litográfico matriz creador estrecho conexión tierra vida . Litógrafa Popular surgir objetivo conservar estética estampa gráfico popular cargado identidad sentido social .	Cultura
lar Norris superar Verstappen gran Premio Singapur Singapur . lar Norris sortear par susto muro ganar contundencia gran Premio Singapur , apenas poder recortar siete punto diferencia Max Verstappen líder campeonato Fórmula Uno . resultado mexicano Sergio Pérez ser completamente inesperar , terminar décimo lugar dificultad rebasar , llevar último punto repartir carrera .	Deportes
Cede lluvia arrancar primero partido miniliga Pacífico lluvia ceder hora fin salir Sol . ser señal sagrado fanático beisbol , aguardar par día tormentoso pudie-ra empezar minitorneo Liga Mexicana Pacífico estadio Fray Nano Ciudad México , mover prisa ganar él partida mal tiempo . así fin arrancar primero juego Cañeros Mochis derrotar 4-0 Sultanes Monterrey . resto partido aún depender condición climático .	Deportes
Slim criticar dinero gastar jubilado pedir combatir pobreza hombre más rico México decir recurso recibir actualmente mayor 65 año deber usar él sacar 6 millón persona pobreza extremo .	Economia
televisaunivisión sustituir Wade Davis director general empresa decidir sustituir Davis Daniel Alegre debido resultado compañía caer debajo expectativa interno .	Ciencia
extremis , Águilas rescatar   valioso empate 1-1 Necaxa gol agónico Henry Martín , América rescatar valioso empate 1-1 Necaxa , hilvanar tres partido conocer derrota , ayer due-lo correspondiente jornada nueve torneo Apertura 2024 Liga Mx , disputado estadio Victoria , Aguascalientes .	Deportes
Elena Poniatowska : Miguel Ángel Salazar González , Diablo Paula Haro , hija , hacer mucho amigo Diablo , venir buscar él Chimalistac después limpiar parabrisa Insurgentes Miguel Ángel Quevedo . Flaquito , huesudo , sonriente , pelo negro cortinar ojo , Diablo llegar desayunar , comer merendar . no rechazar ofrecimiento regaderazo agua caliente . después casi 20 minuto agua , aparecer ropa sonrisa resplandeciar .	Cultura
Banxico ejecutar nuevo recorte tasa 10.5% banco central hacer segundo recorte consecutivo tasa referencia contexto menor inflación .	Economia
Venta gasolina Pemex aumentar 2.8% volumen venta gasolina Petróleos Mexicanos ( Pemex ) agosto promedeír 687 mil barril diario , dato mostrar avance 2.8 ciento frente igual periodo año pasado , revelar estadística empresa estatal .	Economía
India , país querer ser potencia industria semiconductor Estados Unidos India anunciar alianza construir planta chip país , gobierno Biden definir “ punto inflexión ” .	Ciencia
Telefónica Megacable aplicar medida seguridad Culiacán compañía telecomunicación decidir modificar operación sucursal garantizar seguridad trabajador entidad haber ser azotar violencia .	Ciencia
líder tecnológico   acudir Casa Blanca hablar IA : CNN Funcionarios alto rango líder tecnológico dar cita hablar recurso energético infraestructura necesario impulsar herramienta .	Ciencia
Amazon despedir home office : empleado regresar oficina 2025 empresa haber permitir empleado trabajar casa pandemia , haber dejar oficina casi vacío ciudad San Francisco Seattle .	Ciencia
terminar semana peso pérdida ciento peso cerrar retroceso ciento semana , marcado anuncio política monetario banco central Estados Unidos también afectado cautela inversionista aguardar anuncio Banco México próximo semana .	Economía
Lun representar escena magia infancia enigma existencia magia infancia , enigma existencia riesgo pérdida memoria entrelazar Lun , propuesta escénico llegar Teatro Artes Centro Nacional Artes ( Cenart ) , partir fin semana .	Cultura
menopausia poder ocasionar problema dental , decir especialista sofoco sudoración nocturno ser síntoma más infame menopausia . ser posible también desear prestar atención diente encía .	Ciencia
regresar vivo Met Nueva York Auditorio Nacional ocho título temporada 2024-2025 programa vivo Met Nueva York , transmitir 5 octubre 31 mayo pantalla gigante Auditorio Nacional , seguir fiel misión Metropolitan Opera House presentar ópera “ más famoso popular ” , mejor elenco posible , así ofrecer producción nuevo , “ sólo así avanzar forma arte ” , expresar Peter Gelb , gerente general Met .	Cultura
Francia reconocer obra Graciela Iturbide “ Hablo poco francés , entender más Francia ” , asegurar fotógrafa Graciela Iturbide “ parodiar Alfonso Reyes , ser condecorar Orden Artes Letras rango oficial República Francesa , acto cargo embajadora gala Delphine Borione .	Cultura
Fomentar vivienda interés social eliminar corrupción , reto Infonavit Analistas señalar instituto tener pendiente materia avanzar digitalización agilización trámite , así mejorar rendimiento subcuenta vivienda .	Economia
inversión extranjero caer estado más “ atractivos ” nearshoring falta energía eléctrico , escasez agua mano obra , además infraestructura rebasado transporte poner freno decisión inversión .	Economia
