Features	Target
¿ hay mayor brecha salarial género México ? Banxico realizó análisis brechas salariales género regiones México , resultados demuestran norte es hay mayor diferencia remuneración hombres mujeres .	Economia
Intel Amazon firman acuerdo comercial mercado recibe bien empresas tecnología trabajarán conjunto coinversión diseños chip personalizados negocio nube big tech : AWS .	Ciencia
Finaliza   temporada Rodri Manchester . Rodri , mediocampista Manchester City , perderá resto temporada someterse ayer cirugía ligamento anterior cruzado .	Deportes
"Fed baja tasas medio punto porcentual ; aduce "" confianza "" control inflación responsables política monetaria prevén tipo referencia Reserva Federal caiga medio punto porcentual finales año ."	Economia
Chapultepec está listo atender presente enfrentar futuro : Orozco Bosque Chapultepec está listo atender presente encarar futuro , aseguró Jornada artista veracruzano Gabriel Orozco , concluyó labor coordinador proyecto Chapultepec : Naturaleza Cultura , cuarta sección , ya remodelada , inauguró hace días .	Cultura
plan sustituir importaciones Asia nearshoring torna difícil primeros siete meses año , importaciones México Asia alcanzaron 141,219 millones dólares ; China representa 51% total .	Economia
Verstappen , castigado   lenguaje “ grosero ” ; Norris lidera prácticas Max Verstappen cayó nuevo espiral errores persigue Red Bull . jornada ensayos libres Gran Premio Singapur , tricampeón mundial Fórmula 1 logró cuarto mejor tiempo primera ronda , luego fue lugar 15 , quejándose falta adherencia gomas . Quedó 1.2 segundos líder Lando Norris ( McLaren ) , brilló circuito urbano Mari-na Bay delante monegasco Charles Leclerc Carlos Sainz ( Ferrari ) . mexicano Sergio Pérez ubicó octavo puesto .	Deportes
Miguel Díaz Reynoso * : Cuadernos Habana Encuentro cuadernos referencias asalto Cuartel Moncada . Quizá deba empezar preparativos decidió llevarlo cabo 26 julio .	Cultura
“ Misión cumplida ” “ Misión cumplida ” , dijo artista Gabriel Orozco cerrar ciclo casi seis años coordinador proyecto Chapultepec : Naturaleza Cultura , 24 septiembre , presidente Andrés Manuel López Obrador inauguró cuarta sección última faltaba concluir bosque urbano .	Cultura
Alcaraz da triunfo decisivo Europa , campeón Copa Laver París . Europa conquistó ayer Copa Laver tenis combinado resto mundo gracias victoria español Carlos Alcaraz Taylor Fritz último duelo singles .	Deportes
Debajo máscaras están rostros abogados , comerciantes torteros José Orlando Regalado Alonso era conocido arenas Rey Destroyer . lucha Black Spider Jr , 2 marzo Monterrey , regiomontano falleció 22 años caída ocasionó severo daño cerebral . 10 días estuvo internado , luchadores Park , Silver Star Latin Lover recaudaron fondos ayudar familia , debido había problemas pago atención médica . fue más reciente muerte tuvo lamentar deporte . no era cansancio dolor , único podía detener gladiador enmascarado era lesión fulminante . modo vida estaba relacionado riesgo .	Deportes
Reservas internacionales alcanzan marca histórica reservas internacionales cerraron semana concluyó 20 septiembre saldo 226 mil 465 millones dólares , incremento 356 millones dólares relación semana precedente , reveló Banco México ( BdeM ) .	Economía
Cotiza peso prácticamente cambios espera recorte tasas BdeM Ahora incógnita política monetaria México es recorte tasa referencia cuarto medio punto porcentual , Banco México ( BdeM ) despejará jueves . tanto , peso mexicano operó ayer cautela .	Economía
RappiCard alcanza 5,107 millones pesos cartera crédito empresa resalta parte estrategia es ofrecer proceso solicitud aprobación solo dos minutos entrega tarjeta física 30 minutos .	Economia
¿ usar nuevas funciones texto Instagram ? nuevas herramientas texto incluyen más fuentes efectos , así posibilidad agregar texto superpuesto publicaciones feed .	Ciencia
Dodgers Yanquis , primeros sembrados Ángeles . , Dodgers Ángeles Yanquis Nueva York aseguraron sábado ser primeros sembrados playoffs , dominicano José Ramírez , Guardianes Cleveland , colocó jonrón ingresar selecto club 40-40 .	Deportes
BMV gana semana ; peso pierde 28 centavos peso revirtió ganancias iniciales , día después impulso registrado anuncio Banco México recortó tasa interés .	Economía
2026 , Petróleos Mexicanos requerirá 19 mil millones dólares gobierno federal Petróleos Mexicanos ( Pemex ) requerirá gobierno federal 19 mil millones dólares 2026 cubrir necesidades efectivo , operativas pago deuda , aseguró Roxana Muñoz , vicepresidenta analista senior calificadora Moody’s .	Economía
Gasolinas diésel van primer mes subsidios Brindar menores estímulos ha permitido recaudar mayores ingresos secretaría Hacienda ; enero agosto año , ha recaudado 82% más dinero IEPS combustibles .	Economia
Tribunal da 5 días X validar representante legal Brasil Río Janeiro . , red social X nombró representante legal Brasil , exigencias volver funcionar país , seguirá suspendida cumplir requisitos judiciales . Tribunal Supremo Brasil dio plataforma social X , propiedad Elon Musk , cinco días presentar documentos validen nuevo representante legal país , mostró sábado decisión judicial .	Economía
Entusiastas asistentes OSM festejaron Islas CU 114 años UNAM rugido puma resonó volumen sábado Islas Ciudad Universitaria ( CU ) , Universidad Nacional Autónoma México ( UNAM ) celebró 114 aniversario concierto memorable cargo Orquesta Sinfónica Minería ( OSM ) .	Cultura
Norris consigue pole   GP Singapur ; Checo , fuera top-10 mexicano Sergio Pérez ( Red Bull ) entró socavón . Arrancó des-de fondo , esperanzado neumáticos ayudarían remontar , terminó lejos dos pilotos disputan título mundial Fórmula 1 calificación Gran Premio Singapur . Ubicado lugar 13 , tapatío finalizó carrera poco memorable respecto rendimiento Lando Norris ( McLaren ) tricampeón mundial Max Verstappen , primero segundo parrilla salida , respectivamente .	Deportes
Anahit María sale Gran Bretaña Armenia exhibición Diosa Madre : Anahit María , realizada originalmente Museo Británico , fue prestada manera exclusiva seis meses Museo Historia Armenia , ubicado ciudad Yerevan . muestra es reflexión papel femenino materno distintas deidades variadas culturas . imagen , cabeza estatua bronce diosa Anahit , perteneciente cultura persa , data siglo I antes Cristo .	Cultura
estanca producción granos   sexenio producción granos oleaginosas México ha incrementado 37 ciento entrada vigor Tratado Libre Comercio América Norte ( TLCAN ) , actualmente Tratado México , Estados Unidos Canadá ( T-MEC ) , fecha ; embargo , sexenio crecimiento ha estancado , revelan datos oficiales .	Economía
“ feminismo devolvió dignidad existencia , arte también ” : Sofía Weidner “ No prometo salgan alegres mente tranquila exposición . No quise generar arte causara comodidad ” , confesó Sofía Weidner inauguración Musas negras , Museo Ciudad México . Emociones tristes , dolorosas furiosas están plasmadas obras hoy trascienden ser vistas público significan cobijo , abandono soledad sueño cumplido . “ Así feminismo devolvió dignidad existencia , arte también ” , declaró creadora .	Cultura
Repuntó julio economía : Inegi economía mexicana creció más esperado julio , debido incremento ‘ inusual ’ sectores agrícola , ganadero pesca , reveló Instituto Nacional Estadística Geografía ( Inegi ) .	Economía
Fitch S&P descartan degradar calificación México reforma judicial agencias calificadoras ven finanzas sólidas esperan prudencia fiscal Claudia Sheinbaum .	Economia
Espartaco Martínez traslada libro obra Sutra corazón bailarín coreógrafo butoh , Espartaco Martínez , ha interpretado ocasiones obra Sutra corazón , experiencia sensorial torno condición humana necesidad liberación emocional , presentará hoy libro vestíbulo Casa Miguel Alemán Complejo Cultural Pinos Chapultepec enseñanza relacionada volver origen vida .	Cultura
Manuel Ahumada , dibujante “ demasiado viejo punk , muy joven morir ” Era “ demasiado viejo punk , muy joven morir ” , dijo Manuel Ahumada ( 1956-2014 ) Gonzalo Rocha , ambos moneros colaboradores Jornada . “ día elevó más ahora mira cosmos , acompañado dioses aztecas , ángeles astronautas Apolo 11 ” , agregó referencia día aquél falleció personajes eran frecuentes imaginario obra .	Cultura
Google salva multa antimonopolio 1,670 mmd caso comenzó supuesto dominio anticompetitivo empresa mercado publicidad línea .	Ciencia
Microsoft invertirá mil 300 mdd México infraestructura IA nan	Economía
Ahora usuarios Uber también deberán verificar identidad Uber implementará nueva verificación identidad pasajeros , objetivo ofrecer mayor seguridad conductores evitar fraudes plataforma .	Ciencia
Proyecto ministro Pérez Dayán impedirá UIF bloquear cuentas bancarias lavado ministro Alberto Pérez Dayán propondrá endurecimiento requisitos Unidad Inteligencia Financiera ( UIF ) pueda asegurar cuentas bancarias titulares son sospechosos operaciones lavado dinero .	Economía
Peligra economía México Trump gana cumple aranceles : Moody's agencia calificadora anticipa economía mexicana sufriría recesión 2025 mayor inflación .	Economia
Intel logra acuerdo 3,500 mdd fabricar chips ejército trata programa secreto , llamado Secure Enclave , busca establecer producción chips avanzados aplicaciones militares Inteligencia .	Ciencia
primera vez 2 años , tasa Cetes baja 10% Después casi dos años ofrecer rendimientos anuales doble dígito , tasa interés Certificados Tesorería Federación ( Cetes ) ha caído debajo 10 ciento . analistas , indica mercados anticipan Banco México ( BdeM ) reducirá tasa referencia próximo jueves línea Reserva Federal Estados Unidos .	Economía
Brasil ! Brasil ! revela visión vibrante Modernismo Berna . exposición Brasil ! Brasil ! : The Birth of Modernism ( ¡ Brasil ! ¡ Brasil ! : nacimiento Modernismo0 , inaugurada Zentrum Paul Klee , ofrece visión vibrante movimiento artístico país sudamericano largo obra 10 artistas , cinco autodidactas poco conocidos internacionalmente . 130 obras expuestas han salido Brasil primera vez . muestra coincide temáticamente Bienal Venecia , más mitad artistas aquí presentes también participan .	Cultura
Sufre rechazo Alemania reservas Italia posible fusión UniCredit Commerzbank Milán . jefe banco italiano UniCredit , Andrea Orcel , participó viernes reunión virtual representantes alemán Commerzbank , convertirse mayor inversor privado prestamista alemán , informó Reuters fuente conocedora asunto .	Economía
Científicos descubren coral es capaz retener microplásticos Madrid . nueva técnica detección microplásticos descubrió tres partes anatomía coral ( mucosidad superficial , tejido esqueleto ) contienen clase desechos artificiales .	Ciencia
México va facilitar respaldar inversiones EU : Marcelo Ebrard Luego aprobada reforma judicial , próximo secretario Economía revivió posteó video redes sociales dice integración dos economías avanza paso acelerado .	Economia
"Meta presenta Quest 3S , versión "" económica "" visor realidad mixta Meta calificó dispositivo proveedor   “ experiencias increíbles precio inigualable ” ."	Ciencia
e-commerce chino conquista bolsas valores dueños Alibaba , Temu JD conquistan e-commerce mundo , diversifican negocios .	Ciencia
Aterriza nave Soyuz misión récord EEI Moscú . cápsula Soyuz transportaba dos cosmonautas rusosy astronauta estadunidense Estación Espacial Internacional aterrizó Kazajstán , poniendo fin estadía récord pareja rusa .	Ciencia
Economía mexicana crece 0.6% julio actividades primarias encabezaron crecimiento económico país séptimo mes año .	Economia
es audiencia quiere conquistar iPhone 16 Apple es consciente usuarios iPhone 15 difícilmente van renovar smartphone , hay segmento pueden seducir .	Ciencia
Copa Laver equipo resto mundo tomó ventaja 8-4 Copa Laver selección Europa . triunfos estadunidenses Taylor Fritz ( imagen ) Frances Tiafoe alemán Alexander Zverev ruso Daniil Medvedev , respectivamente , fueron fundamentales comandados John McEnroe tomaran delantera justa define hoy campeón acumule 13 puntos Berlín .	Deportes
Toro finaliza lugar 12 Mundial Ciclismo pedalista mexicano Isaac Toro ubicó lugar 12 prueba contrarreloj categoría Sub 23 Mundial Ciclismo Ruta , disputa Zurich .	Deportes
Ricardo Yáñez : Isocronías Siete escritoras ha reunido Minerva Aguilar Temoltzin , autora Vuelo letras , libro nacido recital homónimo ofrecido escritoras tlaxcaltecas organizado Asociación Escritores México . decir Obed González , director Literatura Feria Internacional Libro Coyoacán , – auspiciadora volumen ánimo representativo considera lírica voces femeninas – , es posible palpar “ somos lenguaje , somos flexibles constante transformación ” . Vayamos sucintamente poetas – nacidas años 50 80 – :	Cultura
Microsoft usará energía nuclear alimentar Inteligencia Artificial acuerdo Microsoft Constellation Energy permitirá reactivar unidad planta nuclear Three Mile Island cubrir crecientes necesidades energéticas .	Ciencia
Inversión conectividad no caerá pese política judicial : Neutral Networks CEO compañía Neutral Networks , enfocada infraestructura crítica , dijo necesidad conectividad nivel usuario empresa será más fuerte agendas políticas .	Ciencia
Impulsa CRE infraestructura autos eléctricos disposiciones administrativas materia electromovilidad emitidas Comisión Reguladora Energía ( CRE ) no sólo impulsarán desarrollo infraestructura uso automóviles eléctricos híbridos , también ordenamiento Sistema Eléctrico Nacional ( SEN ) , acuerdo regulador .	Economía
Sinner , “ decepcionado ” apelación AMA Roma . tenista número mundo Jannik Sinner dijo estar “ muy decepcionado sorprendido ” , después Agencia Mundial Antidopaje ( AMA ) decidió impugnar decisión Agencia Integridad Tenis Internacional determinó no hubo culpabilidad dos positivos dopaje .	Deportes
Nintendo The Pokémon Company demandan creador Palworld empresas japonesas iniciaron acción legal contra Pocketpair , debido infracciones patentes desarrollar llamado “ Pokémon armas ” .	Ciencia
Usuarios reportan alerta sísmica nunca llegó celulares IFT había asegurado hoy empresas enviarían mensajes emergencia sismos nunca llegaron . Telcel asegura alertas dependen regulador .	Ciencia
endeudamiento mexicanos exterior representa 35% PIB Banco México ( Banxico ) dio conocer segundo trimestre año redujo endeudamiento mundo 42% reportado primer trimestre .	Economia
Inversiones México mantendrán , pese débil Estado Derecho : UBS banco inversión dijo México mantendrá inversiones , aprovechar potencial ofrece nearshoring .	Economia
México registra déficit comercial 4,868 mdd agosto exportaciones mexicanos cayeron 1% importaciones crecieron 5.7% , acuerdo Inegi .	Economia
Traspié peso espera recorte tasas BdeM peso mexicano debilitó frente dólar miércoles , víspera anuncio política monetaria Banco México ( BdeM ) .	Economía
Pekín recorta tasas estimular economía Pekín . Banco Central China anunció ayer nuevas medidas impulsar economía , recorte tasas interés , incluida referencia hipotecaria , así reducción depósito bancos deben mantener reserva .	Economía
Desacelera inflación anual cuarta quincena consecutiva inflación general primera quincena septiembre México desaceleró 4.66 ciento anual , menor nivel segunda quincena mayo 2024 , revelaron cifras Instituto Nacional Estadística Geografía ( Inegi ) .	Economía
salarios , programas sociales remesas mantienen consumo México Pese inflación mayor tasa interés , consumo privado México ha sido pilar economía , tendencia queda tiempo , advierten analistas .	Economia
Enrique Dussel Peters * : China : ¿ desarrollo través política industrial ? Enfatizamos   colaboración 11 septiembre año profunda competencia Estados Unidos China liderazgo tecnológico global . hubiera sido impensable todavía hace dos décadas principios siglo XXI , lema “ China barata ” .	Economía
Compras maíz Estados Unidos incrementaron 23% sexenio contexto producción granos básicos ha estancado , administración presidente Andrés Manuel López Obrador terminará incremento aproximadamente 23 ciento volumen importaciones maíz Estados Unidos .	Economía
¿ funciona canje teléfonos Mercado Libre ? Mercado Libre lanzó nuevo programa llamado Trade smartphones , puedes canjear antiguo celular modelo nuevo .	Ciencia
Google demanda Microsoft supuesto monopolio nube denuncia fue presentada Comisión Europea , anunció propio Google .	Ciencia
abuelita lucha libre , emblema aficionado fiel espectáculo deportivo interpela público protagonista lucha libre . Lejos ser simples espectadores , ahí asistentes son actores reparto . Exigen piedad condenan sufrimiento conside-ran merece . Más hinchada entusiasta , aficionados pancracio son elenco veces estrellas . representa protagonista butacas inolvidable doña Virginia Aguilera , conocida abuelita lucha libre , más medio siglo representó aficionado fiel apasionado .	Deportes
Enrique Galván Ochoa : Dinero presidenta República     tomará posesión próximo martes , Claudia Sheinbaum Pardo , asistió congreso nacional Morena dijo no será partido Estado ; habrá distancia . pidiera abdicó título jefa partido , ya es jefa Gobierno , jefa Estado comandanta suprema fuerzas armadas . organización guinda enarbolará bandera 4T. Fue fundada presidente Andrés Manuel López Obrador . Ha anunciado mil veces retirará quinta Palenque , , asegura , llevará vida aislamiento política políticos . Incluso no recibirá amigos . Dos círculo más íntimo fueron elegidos dirigir formalmente partido : Luisa María Alcalde , presidenta Andrés Andy López Beltrán secretario Organización . Serán ojos voz .	Economía
Gana América Campeones Cup nan	Deportes
Vilma Fuentes : Entusiasmo melancolía Encuentros deportivos Juegos Olímpicos Copa Mundial futbol provocan amplios movimientos entusiasmo envidian políticos estrellas cine . detenemos segundos observar aumento pasión suscitan medida desarrollan , podríamos sentir curiosidad causas .	Cultura
Cruz Azul , intratable ; vence 1-0 Chivas afianza superliderato Hay partidos marcan agenda Cruz Azul . Después clásico joven América , rivalidad Guadalajara tiene valor especial . peso escenario importante , Máquina volvió cantar victoria estadio Ciudad Deportes ( 1-0 ) mantenerse único líder Liga Mx seguir carrera campeonato .	Deportes
Brasil desbloquea cuentas Starlink X transferencia 3 mdd juez Supremo Tribunal dijo levantamiento ordenó cantidad transferida arcas Brasil alcanzaba total X debía país concepto multas .	Ciencia
Seguridad energética , amenazada nivel mundial tensiones geopolíticas : WEF transición energética nivel global observa avances , particular economías desarrolladas , así China Brasil . No obstante , equidad ha retrocedido tensiones geopolíticas causan incertidumbre seguridad energética , revela informe Foro Económico Mundial ( WEF , siglas inglés ) .	Economía
Intel aplaza proyecto instalar fábricas Alemania Polonia anuncio presenta después revelara empresa recibirá 3,000 millones dólares gobierno estadounidense fabricar semiconductores .	Ciencia
Guadalajara deja escapar valioso triunfo ; iguala 1-1 Monterrey partido intensidad polémica arbitral incluida , Chivas dejó escapar importante triunfo empatar 1-1 Monterrey duelo jornada 10 torneo Apertura 2024 , disputado ayer estadio Akron .	Deportes
Pemex Infonavit , es Octavio Romero Oropeza presidenta electa , Claudia Sheinbaum , dio conocer Romero Oropeza estará frente Instituto Fondo Nacional Vivienda Trabajadores .	Economia
Pumas sufre más , rescata victoria 1-0 Xolos Pumas sufrió más , rescató domingo importante triunfo 1-0 Xolos Tijuana , resultado catapultó zona liguilla , duelo correspondiente jornada nueve torneo Apertura 2024 Liga Mx , efectuado estadio Olímpico Universitario .	Deportes
inflación cede , Banxico enfrenta más retos bajar tasa interés volatilidad tipo cambio generada avance reforma judicial representa freno banco central   bajar tasa interés referencia .	Economia
CASA celebra talleres creativos tamales Día Nacional Maíz Nativo Oaxaca , Oax . , celebrar Día Nacional Maíz Nativo , conmemora hoy , Asociación Civil Francisco Toledo realiza colaboración Fundación Alfredo Harp Helú Oaxaca ( Fahho ) actividades espacios fundados artista juchiteco ( 1940-2019 ) , luchó defensa grano escala estatal nacional .	Cultura
Banxico sólo tiene espacio hacer recorte 25 puntos analistas consideran banco central debe tener cautela bajar tasas periodos volatilidad descartan hagan recorte 50 puntos hizo Reserva Federal .	Economia
Dos olímpicos conquistan   Zúrich campeones olímpicos Remco Evenepoel ( imagen ) Grace Brown conquistaron ayer pruebas contrarreloj Mundial Ciclismo , celebra Suiza . Brown , australiana 32 años , proclamó campeona mundo primera vez quedar segunda últimos dos años , Evenepoel revalidó título 46.1 kilómetros Zúrich , tiempo 53 minutos 2 segundos . belga 24 años competirá carrera ruta domingo .	Deportes
jubilación digna complica vez más mexicanos quinta parte empleados país contempla jubilarse 66 años más , 86% admite ahorrar menos debería hacerlo actualidad .	Economia
BdeM recortará tasa cuarto punto , anticipa encuesta Analistas económicos consultados Citibanamex anticiparon nuevo recorte 0.25 puntos porcentuales tasa interés referencia Banco México ( BdeM ) reunión próxima semana , estiman ubique 10 ciento cierre 2024 .	Economía
China sufre exceso ... leche mercado leche China enfrenta situación complicada exceso oferta , baja demanda pérdidas millonarias .	Economia
sexenio AMLO , banca ganó más un billón pesos largo sexenio presidente Andrés Manuel López Obrador , conjunto bancos privados operan país han ganando poco más un billón pesos , resultado histórico coloca sector mejor fue gobierno Cuarta Transformación , afirman especialistas .	Economía
David Márquez Ayala : Reporte económico múltiples logros     administración ahora termina , producción alimentos avance autosuficiencia no es , desafortunadamente , . producción cuatro granos básicos alimentación mexicana ( maíz , trigo , frijol arroz ) ascendió 2023 31.9 millones toneladas , apenas 1.0% producción 2018 ( Gráfico 1 ) . productos , periodo producción maíz aumentó 1% , trigo 18.1 , decrecieron frijol – 38.3% arroz 11.2% .	Economía
Tigres rescata empate dos León ; es sublíder polémicas decisiones arbitrales , Tigres rescató empate 2-2 León gol último minuto argentino Juan Brunetta . universitarios valieron criterio silbante Daniel Quintero Huitrón , invalidó dos tantos esmeraldas inclinó balanza favor , igualar encuentro .	Deportes
Pemex requerirá 50,200 mdd tres primeros años Sheinbaum , prevé Moody's apoyo gobierno calificación real Pemex sería Ca , es decir 80% incumplimiento compromisos financieros .	Economia
México EU acuerdan Sader supervise aguacate exportación gobiernos México Estados Unidos acordaron transferencia responsabilidades agilizar comercio .	Economia
obra Nombres combate reúne foro Gruta historias vida resistencia Hay historias merecen ser contadas , no sólo resultan dolorosas heroicas , “ son testimonios vida , cariño resistencia ” , afirmó Martín López Brie , dramaturgo director Nombres combate , obra documental presenta partir hoy foro Gruta , haber enfrentado dificultades propias pandemia .	Cultura
Tigres batallan vencer último lugar torneo duelo fue más complejo esperado , Sebastián Córdova logró darle Tigres triunfo 1-0 sotanero Ciudad Juárez , jornada nueve torneo Clausura 2024 Liga Mx . victoria , felinos escalaron segundo puesto tabla general 20 unidades , dos puntos diferencia líder Cruz Azul .	Deportes
Samsung abre puertas : así conviven humanos brazos mecánicos comenzó planta producción refrigeradores , hoy es centros más importantes Samsung mundo .	Ciencia
Fotografiar es pretexto buscarme : Graciela Iturbide Arropada larga ovación , fotógrafa Graciela Iturbide recibió Medalla Bellas Artes Oro 2024 Artes Visuales , otorga Instituto Nacional Bellas Artes Literatura ( Inbal ) , icónicas imágenes , conjugan documental poético , forman parte esencial acervo gráfico contemporáneo México .	Cultura
Revolut planea operar primeros meses 2025 Juan Guerra , director general firma , dijo espera arrancar operaciones siguiente año cuenta débito nivel 4 transferencias internacionales .	Economia
medio crisis , industria gaming busca nuevo modelo negocio despidos han marcado año videojuegos , especialistas apuntan es nueva oportunidad diversificar contenido creadores independientes .	Ciencia
Beneficios sociales seguro médico , deuda pendiente Hay frase lucha libre revela realidad desafortunada gladiadores : “ sabemos vamos subir , no va-mos bajar ” . halo peligro acompaña dentro cuadrilátero , casi han sufrido lesiones alto grado incluso no han vuelto despertar caer lona ; pese riesgos , mayo-ría trabaja seguro médico , sólo confianza salir ilesos , mejor aún , vivos .	Deportes
impacto nearshoring tendencias laborales MetLife México escasez talento calificado , importancia beneficios competitivos necesidad cultura organizacional sólida son principales desafíos enfrentan empresas	Economia
Raúl Pineda saca luz oscuridad dolor tragedia atraviesan país Traer luz oscuridad es labor artista Raúl Pineda , don memoria fotográfica excesiva persistencia técnica antigua grabado mezzotinta retrata horror desencajado violencia México .	Cultura
Chaquito estará fuera tres meses nan	Deportes
Lactalis reduce casi 10% adquisición leche Francia grupo Lactalis , líder mundial sector lácteo , anunció reducirá finales año volúmenes leche recogidos granjas francesas destinados mercados internacionales , centrarse productos vendidos Francia .	Economía
Mercado Pago hace oficial : presentó solicitud ser banco digital cuenta digital busca aprobación licencia bancaria Comisión Nacional Bancaria Valores ofrecer servicios banca múltiple .	Economia
Yuriria Iturriaga : No sólo pan ... sorprende categoría son ajenas mayoría personas han rodeado vida decenios , sorpresa no es sólo sentir diferenciamos compatriotas mexicanos , , caso , repentina nostalgia paladar , olfato tacto intrabucal infinito mundo pan pasteles , casualidad , pertenecen mundo trigos , es decir , gluten ataca orientales mesoamericanos vieja cepa , no note …	Cultura
iOS 18 , incluye nueva versión actualizar iPhone todavía no ha integrado Apple Intelligence , actualización sistema operativo integra serie mejoras .	Ciencia
Haaland marca gol 100 empate City Erling Haaland marcó gol 100 Manchester City . delantero comparado androide , más número es historia pura . noruego puso adelante equipo Arsenal , quedó 10 jugadores , también inspiró empate 2-2 últimos minutos , John Stones encargó sentenciar .	Deportes
rendimientos Cetes tocan nivel más bajo enero rendimientos Cetes 28 días tuvieron tasa más baja enero pasado expectativa Banxico haga más recortes tasa referencia .	Economia
AMLO , México consolidó principal socio EU administración presidente Andrés Manuel López Obrador ( AMLO ) , primera vez historia , México convirtió consolidó principal socio comercial Estados Unidos , mayor potencia económica mundo . embargo , dicen especialistas , futuro cercano aún quedan retos importantes , ejemplo , definir relación gigante mundial , China , revisión T-MEC , instrumento potenció relación .	Economía
Nadal vuelve competir liderar España final Copa Davis París . leyenda tenis Rafael Nadal , junto número tres mundial , Carlos Alcaraz , liderará España Final 8 Copa Davis , anunció equipo capitaneado David Ferrer torneo disputará 19 24 noviembre , Málaga .	Deportes
Instituciones crédito incertidumbre Reforma Judicial , dice Moody’s pequeñas medianas empresas enfrentarán desaceleración créditos dada falta certeza jurídica instituciones financieras no bancarias .	Economia
gobierno Sheinbaum necesitará nueva política atraer inversiones Consumada desaparición ProMéxico , esfuerzos atraer inversión extranjera dividieron . especialistas cuestionan ente líder podría lograrse aún más .	Economia
México expropia minera Calica ; empresa estadunidense impugnará firma estadunidense Vulcan Materials anunció va impugnar legalmente decisión gobierno mexicano , anunciada lunes noche , expropiar terrenos mina Calica Quintana Roo .	Economía
escritura manual código tiene días contados , vaticina CEO NVIDIA Jensen Huang explicó 32,000 ingenieros software estarán acompañados 100 veces más asistentes digitales , 24 horas día , 7 días semana .	Ciencia
Condusef alerta suplantación identidad 24 financieras Veinticuatro instituciones debidamente constituidas han reportado suplantación identidad cometer fraudes usuarios .	Economia
Bravos vencen Mets acercan comodín Atlanta . Bravos Atlanta hicieron tarea lucha alcanzar boleto comodín postemporada Grandes Ligas . ganar 5-1 Mets Nueva York , quedan victoria conseguir meta .	Deportes
Javier Aranda Luna : Kundera : novela desafío rebeldía 8 diciembre 1968 , año recurrente historia mundo , cuatro amigos embarcaron expedición extraordinaria Praga .	Cultura
cuadrilátero , aguerrido ritual cautiva público medio crecimiento mediático industria entretenimiento , lucha libre mexicana mantiene identidad popular cercanía afición , integrada profesionistas , trabajadores , niños incluso extranjeros complementan escenario espectáculo mezclan deporte , drama cultura .	Deportes
Leyendas pancracio regresan Coliseo Día nacional luchador hombre , ocasiones mujer , máscara sube ring arena Coliseo , afición ovaciona , no importa es rudo técnico , saben está cuadrilátero arriesgar vida medio espectáculos más vistosos , folclóricos polémicos deporte : lucha libre . Místico , Octagón Atlantis , leyendas disciplina , fueron ayer representantes históricos función motivo Día nacional luchador lucha libre .	Deportes
papel economía bienestar gobiernos modernos economía bienestar prioriza salud felicidad personas , colocando valores nivel , incluso encima , indicadores económicos tradicionales PIB .	Economia
Cetes dos años reducen rendimientos dígito , anticipa recorte Banxico plazos Cetes redujeron ganancias , plazo dos años ofrece tasa más baja 9.92% , espera Banxico haga nuevo recorte .	Economia
Jaime Munguía regresa grande   gana nocaut Jaime Munguía regresó ring plan grande . dura pelea canadiense Erik Bazinyan , Glendale , Arizona , pugilista mexicano consiguió victoria vía nocaut décimo asalto , luego poderoso gancho mano izquierda ocasionó derrumbe rival . Bazinyan intentó pararse , recibió cuenta réferi , no encontró fuerza piernas aceptó derrota . combate dejó manos tijuanense título plata peso supermediano CMB . “ Fue pelea fuerte , pesada , momento Bazinyan lastimó . Tuve ir abriéndolo poco poco . Ahora , queremos mejores peleas . siguiente año gustaría enfrentar Caleb Plant Édgar Berlanga ” , declaró Munguía , no peleaba derrota tapatío Saúl Canelo Álvarez .	Deportes
AMLO busca convertir CFE Telecom empresa pública iniciativa reforma quiere CFE TEIT sea principal compañía proveer internet país , respecto competidores , cambiando estatus estatal pública .	Ciencia
Telmex suspende atención quejas Centros servicios Culiacán Sindicato Telefonistas dijo debido enfrentamientos armados entidad , decidió no abrir tiendas , centros trabajo resguardar integridad técnicos .	Ciencia
México pierde penales leyendas FIFA planteles repletos figuras épocas , equipos leyendas FIFA Monterrey protagonizaron partido exhibición congregó miles personas estadio BBVA , actual casa Rayados sedes México Copa Mundo 2026 . Andrea Pirlo , Dwayne Rosario Youri Djorkaeff marcaron internacionales , ex seleccionados tricolores Luis Hernández , Miguel Layún Jorge Campos lograron empate tres . Ya penales , representantes FIFA impusieron 5-4 . Dada inactividad participantes retiro profesional , organizadores ajustaron dimensiones terreno juego . leyendas FIFA estuvieron arquero Gianluigi Buffon , Alessandro Piero , Didier Drogba , Carles Puyol , Xavi Hernández Diego Forlán . México destacaron Oribe Peralta , Luis Hernádez , Jorge Campos , Guillermo Franco , Paul Aguilar técnico Bora Milutinovic .	Deportes
León Bendesky : ejemplo escritor inglés H.G. Wells apuntó Historia supervivencia misma dependen carrera educación catástrofe . idea es adecuada reflexionar cuestiones hoy son relevantes persistente violencia hay mundo , bien , incapacidad humanidad contener degradación medio ambiente .	Economía
Mexicana presenta avión Embraer sumará flota 2025 Zumpango , Méx . , fin consolidarse industria transporte aéreo nacional , Mexicana Aviación , aerolínea Estado mexicano , presentó avión Embraer E195-E2 , modelo adquirieron 20 unidades aerolínea empezará recibir partir mayo 2025 .	Economía
"OpenAI lanza nueva serie modelos IA capacidad "" razonamiento "" modelo conocido internamente strawberry tuvo altas calificaciones pruebas matemáticas codificación . empresa reconoce aún puede dar respuestas limitadas ."	Ciencia
Cetes reducen rendimiento previo decisión Banxico próxima semana , Banco México ( Banxico ) dará conocer decisión política monetaria Cetes disminuyeron rendimientos plazos .	Economia
Concentra manufactura flujo inversión extranjera : enero 2023 septiembre 2024 , sector privado realizó 575 anuncios inversión México más 170 mil 644 millones dólares , revelan datos actualizados Secretaría Economía ( SE ) .	Economía
Desequilibrio balanza comercial acumuló 10 mil 438 mdd agosto balanza comercial país observó agosto 2024 déficit 4 mil 868 millones dólares , dinamismo explicó retroceso ciento exportaciones frente igual periodo año anterior , informó Instituto Nacional Estadística Geografía ( Inegi ) .	Economía
Yanquis , ya clasificados playoffs , caen 9-4 Pittsburgh Nueva York . , Yanquis , ya clasificados postemporada Grandes Ligas , cayeron ayer 9-4 Piratas Pittsburgh , pegaron cinco jonrones , incluyendo cuatro frente novato dominicano Luis Gil . resultado , retrasó equipo Nueva York consiguiera ventaja casa playoffs Liga Americana .	Deportes
Banxico proyecta nearshoring México 2026 2030 encuesta Banco México , 41.3% empresas consultadas estima mayor beneficio proceso relocalización dará periodo .	Economia
Retrasos ferrocarril México-EU afectan suministro agrícola Chicago . retrasos transporte ferroviario están perturbando comercio exportación Estados Unidos México cadenas suministro agrícola plena cosecha otoño boreal , denunciaron ayer organizaciones agrarias .	Economía
Volkswagen negocia sindicatos Después explosivo anuncio Volkswagen podría cerrar fábricas Alemania primera vez , dirección empresa sindicatos iniciarán tensas conversaciones nuevo acuerdo salarial . empresa ha subrayado repetidamente costes son excesivos márgenes beneficio demasiado bajos , especialmente marca principal .	Economía
Filis coronan Este Nacional ; terminan dominio Bravos Filadelfia . Filis Filadelfia ganaron División Este Liga Nacional primera vez 2011 aseguraron título victoria 6-2 Cachorros Chicago . Además , terminaron racha Bravos Atlanta coronarse seis temporadas consecutivas división .	Deportes
IFT prevé publicar nuevas medidas regulatorias América Móvil noviembre regulador tiene obligación revisar dos años medidas regulatorias compañía controlada Carlos Slim verificar han generado competencia telecomunicaciones .	Ciencia
Telmex suspende Sebog servicio resguardo información impagos Triara , división Centros Datos Telmex , suspendió servicios resguardo información Gobernación impago 63.7 millones pesos .	Ciencia
desempleo Alemania aumenta más previsto Berlín . número desempleados Alemania aumentó más previsto septiembre , nueva señal retos enfrenta mayor economía Europa .	Economía
Título Copa Campeones motiva   América duelo Pumas : Dávila reciente obtención título Copa Campeones es factor motiva América cara clásico capitalino domingo Pumas , aseguró delantero Víctor Dávila , además indicó más allá tratar derrotar acérrimos rivales , equi-po buscará toda costa triun-fo ubicarse zona liguilla .	Deportes
Recauda SAT seis años 3.5 billones pesos sexenio está concluir , Servicio Administración Tributaria ( SAT ) recaudó 3.5 billones pesos auditorías promoción cumplimiento , representó 2.3 billones pesos más sexenio anterior crecimiento real 120.2 ciento agosto año .	Economía
Sofipos ven oportunidades figura , pesar migración bancaria Asociación Mexicana Sofipos ( AMS ) considera nueva regulación , instituciones pueden seguir creciendo ayuda regulación tecnología .	Economia
Dallas , esperanza frustración Lamar Jackson Baltimore resistieron intento remontada Dallas , llegó tarde . dos anotaciones estelar mariscal campo , Cuervos derrotaron 28-25 Vaqueros encuentro marcado suspenso minutos finales .	Deportes
Openbank lanza lista espera clientes mexicanos Openbank México abre sitio web lista espera usuarios quieran acceder oferta nuevo banco digital .	Economia
Dubois noquea Joshua retiene cetro pesados Londres . Daniel Dubois retuvo título pesados Federación Internacional Boxeo ( FIB ) noquear quinto asalto ex bicampeón Anthony Joshua , primera defensa cinturón realizada estadio Wembley	Deportes
Janet Yellen opone reducir requisitos capital bancos secretaria Tesoro Estados Unidos pidió seguir trabajando sistema financiero sea resistente tiempos turbulencias .	Economia
López Obrador inaugura Veracruz Centro Cultural Leyes Reforma Veracruz , Ver . , presidente Andrés Manuel López Obrador inauguró ayer puerto Veracruz Centro Cultural Leyes Reforma , realizó recorrido recién rehabilitada Casa Benito Juárez , espacios abrirán puertas visitantes partir noviembre , busca generar reflexión leyes más importantes publicadas siglo XIX .	Cultura
Entregan Tolita María Figueroa Medalla Oro Bellas Artes 2023 teatro hermanas Tolita María Figueroa fueron distinguidas martes Medalla Oro Bellas Artes 2023 disciplina teatro . reconocimiento celebra destacada trayectoria prolífica obra ámbito vestuario escenografía , campos “ han dejado huella imborrable más tres décadas ” .	Cultura
Muñeca Lele otomí representa principal fuente empleo Santiago Metztititlán Pachuca , Hgo . , Artesanas indígenas otomíes Santiago Metztititlán , municipio Amealco Bonfil , estado Querétaro , generaciones han elaborado tradicional muñeca Lele , nació deseo niñas localidad jugar ser mamás .	Cultura
TikTok Departamento Justicia enfrentan tribunales EU abogados TikTok enfrentarán Departamento Justicia tribunal Washington destino ley podría prohibir aplicación vídeos cortos .	Ciencia
PlayStation lanza edición limitada aspecto noventero consola evoca aspecto primer equipo , lanzado Sony 1994 , forma parte celebración 30 años .	Ciencia
Tuzos salen crisis ; derrotan Puebla visita Pachuca reordenó piezas rompecabezas . victorias fechas anteriores , Tuzos volvieron ganar Liga Mx imponerse 3-2 Puebla estadio Cuauhtémoc . Mucho tuvo ver debilidad defensiva Franja , más contundencia delanteros Salomón Rondón Nelson Deossa , fueron figuras ataque .	Deportes
Silvia Ribeiro * : Ayotzinapa , impunidad olvido saber paradero , justicia tortuoso camino encubrimientos impunidad , cumplen 26 septiembre 10 años desaparición forzada 43 estudiantes escuela normal Raúl Isidro Burgos Ayotzinapa asesinato seis personas , tres estudiantes .	Economía
Gasolina Magna va segunda semana subsidios semana 14 20 septiembre , consumidores pagarán 6.1752 pesos Impuesto Especial Producción Servicios ( IEPS ) litro gasolina regular .	Economia
CFE Telecom perfila nuevo CEO impulsar proyecto internet dos fuentes conocimiento tema , interior compañía ha puesto mesa nombre Emiliano Calderón Mercado ser nuevo CEO estatal telecomunicaciones .	Ciencia
Empresas EU reactivarán anuncios inversión ; confían Sheinbaum detener anuncio importante inversión reforma judicial , American Society of Mexico informó próximas fechas retomará , cautela .	Economia
Hermann Bellinghausen : Stravinski vendedora discos segunda parte     años 40 siglo XX Ciudad México debió ser tranquila , optimista , promisoria . cielo azul limpio , sorprender , era normal siempre ciudad lagos , finalmente derrotados , futuro . Allí hizo familia , venida menos , parecida salían películas Soler , Pedro Infante Joaquín Pardavé . conformaban seis varones cuatro hembras . tono época , primeros eran debilidad madre , derechos hombre , sagrados . contaban alcohólico , vividor , perezoso , odiaba ser mexicano , menor edad único estudió carrera . tenía obligación aportar casa , quiera pasaba dificultades financieras ; siempre estaban “ arrancados ” . Tampoco mamá gustaba trabajo , papá hacía mala gana , no viendo hora iría caza escuchar ópera música clásica amigos . Pronto comenzaría recibir pensión burócrata .	Cultura
Ten Hag une críticas saturación partidos Londres . técnico neerlandés Manchester United , Erik ten Hag , criticó sobrecarga partidos , ya considera “ casi inevitables ” lesiones graves sufren futbolistas , ocurrió pasado fin semana arquero alemán Marc-André Ter Stegen ( Barcelona ) mediocampista español Rodri ( Manchester City ) .	Deportes
Caso FTX : rol Caroline Ellison fraude pasará 2 años presa exdirectora Alameda Research , fondo cobertura personal Bankman-Fried , también deberá pagar multa 11,000 mdd .	Ciencia
BBVA advierte reforma Poder Judicial socava Estado derecho análisis banco considera perspectivas crecimiento económico México también pueden deteriorarse .	Economia
Salir bache natación será imposible modelo actual : Liliana Ibáñez sistema deportivo mexicano mantenga obsoleto lucha egos autoridades no detenga , será imposible natación salga bache encuentra hace décadas . Liliana Ibáñez , más experimentadas disciplina , levantó voz profunda crisis prevalece país .	Deportes
Ó : Instrucciones salir agua desmonta mito Ofelia mirada feminista “ Ser no ser ” , escucha escena . famosa frase no pronuncia Hamlet , mujer cuestiona opción es morir , dormir tal vez soñar . trata propuesta escénica Ó : Instrucciones salir agua , conjuga teatro físico danza repensar personaje shakesperiano Ofelia mirada moderna feminista . María Fernanda Baez interpreta unipersonal inició temporada teatro Milagro .	Cultura
Alerta sísmica llegará teléfonos próximo 19 septiembre : IFT Telcel , AT&amp;T , Telefónica Bait comenzarán enviar notificaciones emergencia   , huracanes inundaciones celulares .	Ciencia
mercado tabletas busca conquistar diseñadores , creativos melómanos Lenovo Huawei presentaron nuevas tabletas mercado mexicano coincidencia apuestan conquistar creativos .	Ciencia
Es poco probable México pierda grado inversión : Moody's agencia señala mayor déficit fiscal , absorber deuda Pemex bajo crecimiento sí pueden impactar calidad crediticia .	Economia
¿ Abren bancos 1 octubre ? dice calendario CNBV 1 octubre , Claudia Sheinbaum toma posesión primera presidenta México , implica suceso trascendencia nacional , mayoría empleados descansará .	Economia
Aumentó ingreso divisas turísticas ; elevar llegada viajeros es gran reto indicadores marcan potencialidad turística nación es captación divisas viajeros internacionales , afirma Miguel Torruco , titular Secretara Turismo ( Sectur ) . Medido forma , largo sexenio , país ha incrementado presencia nivel mundial , muestran datos oficiales .	Economía
Coparmex advierte reforma judicial afectará proyectos clave economía organismo empresarial lamenta aprobación Senado República , señaló es decisión no tomó cuenta diferentes voces .	Economia
auditorías dan ingresos 3.5 billones pesos SAT recursos , 1.426 billones pesos obtuvieron auditorías grandes contribuyentes , informa fisco .	Economia
José Antonio Rojas Nieto : economía Estados Unidos : cuarta apreciadísima doctora     Edith Klimovsky Barón , profesora distinguida UAM Azcapotzalco , presentó reciente congreso Economía Matemática Tlaxcala ponencia plantea Edith dixit – ejes determinan muestran relación salarios beneficios . Relación fundamental Clásicos , evidente Marx , duda – pesar – Neoclásicos .	Economía
Expertos : mayor desastre ecológico Riviera Maya mina Sac-Tun , antes conocida Calica , propiedad Vulcan Materials es “ mayor desastre ecológico ” Riviera Maya , más tres décadas extrajo material exportar barco Estados Unidos , acuerdo especialistas gobierno mexicano .	Economía
Tequila , mira China Qionglai , Chengdú . , medio montañas albergan sitios más grandes observación luciérnagas Asia , está creciendo atractivo mexicano parte comercialización destilados . Qionglai – condado 2 mil 300 años historia remiten antigua Ruta Seda – busca incluir tequila proyecto erigir meca bebidas espirituosas ; incluso importar jugo agave producción local .	Economía
México busca ser máximo exponente Homeless Cup Luego largo viaje Corea Sur , selecciones futbol calle cumplieron objetivo estar final Homeless World Cup están pasó convertirse máximos exponentes torneo .	Deportes
Vilma Fuentes : Buenos días , Jacques ( 1936-2024 ) Jacques Bellefroid murió mañana 20 septiembre 2024 . Escribo frase poco más 24 horas después sucedido escándalo indecible . fechas confunden días no cesan girar ruleta horas , repiten infinito , , siempre siempre . muerte , Jacques , vida , amor . No comprendo puedo seguir viva estás muerto , menos es dicen . dijo Tania ayer inicios tarde asoleada , aquí , hospital Charles Foix , afueras París , estoy hospitalizada sigo viva ya has ido aquí no sé . ¿ podré encontrarte nuevo infinita inmensidad has ido ? Búscame , pido busques . Sólo puedes encontrarme laberinto túneles pasajes , muros puertas , señales sentidos .	Cultura
“ quedaría corto hablar significa Jornada México ” Hace poco más 40 años “ había más periodismo , decirlo manera , además grandes diarios , estaban Figaro , Cine Mundial , Redondel , segunda Ovaciones , Últimas Noticias , Extra . Hoy es cochinada , es difusor noticias no noticias ; están lados . panorama , importante es exista Jornada , da lugar lectores ” .	Cultura
Moody's prevé reforma judicial debilite calidad crediticia México cambios sistema judicial perjudicarían futuras inversiones nearshoring , dice agencia calificadora .	Economia
“ Hemos luchado mundo diferente ” Medallas Bellas Artes 2023 2024 ámbitos Arquitectura Patrimonio fueron entregadas ayer Enrique Ortiz , Sara Topelson , Gabriel Mérigo Salvador Aceves .	Cultura
Joseph E. Stiglitz , Kevin P. Gallagher , Martín Guzmán Marilou Uy Especial Jornada : FMI debe poner fin destructivos recargos nan	Economía
Ser longevo cuadrilátero requiere mentalidad fuerza : Felino longevidad puede ser grandes bondades lucha libre , siempre “ cuides tu cuerpo aprendas escucharlo ” , aseguró Felino , 60 años trayectoria cuatro décadas sigue cautivando aficionados función impresionantes llaves espectaculares acrobacias .	Deportes
YouTube lanza nueva herramienta ayudarte emergencia médica través división Health , plataforma videos colaboró instituciones certificadas , Cruz Roja , dar información situaciones urgencia .	Ciencia
Ocupa México séptimo lugar adopción inteligencia artificial México es países adoptantes inteligencia artificial ( IA ) , índice 46.85 puntos , coloca séptima posición 19 encuentran incorporando tecnología , informó Comisión Económica América Latina Caribe ( Cepal ) .	Economía
"Banqueros esperan leyes secundarias reforma judicial den certidumbre aprobación reforma Poder Judicial ,   banqueros esperan leyes secundarias afinen detalles permitan reforma "" exitosa "" ."	Economia
sexenio fueron repatriadas 14 mil 48 piezas , destacan mañanera últimas conferencias mañaneras presidenciales , funcionarios presentaron balance acciones recuperación memoria histórica preservación patrimonio cultural , destacó repatriación 14 mil 48 piezas extranjero .	Cultura
austeridad selectiva predominó gobierno AMLO Más recortes gastos onerosos generar ahorros , gasto público llegó niveles récord , obedeciendo prioridades obligaciones gobierno cargo Andrés Manuel López Obrador .	Economia
Claudia Sheinbaum reunirá empresarios Estados Unidos octubre medio voces empresariales dicen inversiones han detenido reforma judicial , Marcelo Ebrard anunció asistencia próxima presidenta México CEO Dialogue .	Economia
Carlos Fernández-Vega : México SA Ernesto Zedillo fue     seis depredadores Estado instalados Pinos régimen neoliberal , igual gerentes estirpe , dedicó entregar bienes nación gran capital . bien sello sexenal fue ilegal “ rescate ” banca , vía Fobaproa , personaje ahora intenta reivindicar derecha autóctona fue más allá , siempre contra intereses nacionales .	Economía
OCDE ajusta baja previsión PIB México acuerdo organismo , economía mexicana crecerá 1.4% año , 0.8% menos previsión anterior .	Economia
Confía sector empresarial remontar pronóstico crecimiento Consejo Coordinador Empresarial ( CCE ) confió economía mexicana superará pronósticos crecimiento apuntan desaceleración .	Economía
Amazon lanza nuevo bot ayudará crecer ventas empresa dio conocer Amelia obtener datos venta inventario negocio está plataforma .	Ciencia
crear diario personal IA WhatsApp inteligencia artificial WhatsApp , Meta AI , puede aprovecharse realizar simplificar tareas . Aquí explicamos crear diario personal	Ciencia
Intel , nuevo objeto deseo industria tech empresa pionera industria chips ha sido objeto nuevos rumores posible adquisición parte Qualcomm , así inversiones firmas capital .	Ciencia
“ conclusión proyecto Naturaleza Cultura es prioridad gobierno entrante ” proyecto Chapultepec : Naturaleza Cultura no ha dado concluido . mantendrá prioritario próximo gobierno federal , afirmó subsecretaria Desarrollo Cultural Secretaría Cultura federal ( SC ) , Marina Núñez Bespalova .	Cultura
Lucía García rescata Rayadas jugadoras mayor jerarquía internacional , española Lucía García rescató campeón Monterrey conseguir agónico empate 1-1 León estadio Nou Camp . Rayadas , han sufrido torneo Clausura 2024 Liga Mx Femenil , desplazaron América tercer puesto 26 unidades después 12 jornadas , tiempo Esmeraldas tienen 12 puntos .	Deportes
Elena Poniatowska : Grito madrugada 16 septiembre 1810 , “ Grito Independencia ” , historia dio cura Miguel Hidalgo Costilla pueblo Dolores , Guanajuato , rasgó cielo hizo estallara movimiento Independencia .	Cultura
TikTok vs EU : historia antaño no tiene fin claro prohibición llegaría enero 2025 , empresa interpuso demanda evitar restricción , candidatos presidencia tampoco quieren bloquear .	Ciencia
Microsoft confía México ; invertirá 1,300 mdd ampliar alcance IA CEO compañía , Satya Nadella ,   destacó capital será mejorar capacidades nube IA región .	Ciencia
Uber Didi operan sitios AICM , pese restricciones usuarios continúan pidiendo servicio taxis aplicación Uber apunta continuará operando regularidad .	Ciencia
Alistan inauguración Museo Vivo Muralismo días final gobierno presidente Andrés Manuel López Obrador , concluyeron obras restauración , rehabilitación mantenimiento Museo Vivo Muralismo ( MVM ) , prevé inaugurar semana edificio histórico Secretaría Educación Pública ( SEP ) , reconocido patrimonio mundial Organización Naciones Unidas Educación , Ciencia Cultura ( Unesco ) .	Economía
Cruz Azul , líder arrollador ; remonta impone Pachuca Hidalgo líder Cruz Azul apareció tarde estadio Hidalgo . más 40 minutos jugó equipo errático , irreconocible , fue abajo dos goles marcador . vez funcionó plan partido , grado dificultad siempre expulsión incluida Sergio Damián Barreto fuerte entrada Luis Romo , Máquina vino atrás ganar 4-2 mantenerse cima Liga Mx .	Deportes
IFT pedirá 1,680 mdp presupuesto pese reforma eliminar autónomos regulador aseguró partida solicitará Hacienda es fue aprobada año incluso más baja toma cuenta inflación .	Ciencia
Mira Murati , CTO OpenAI , deja empresa 2024 ha sido año complicado startup Inteligencia Artificial , ejecutivos fundadores han renunciado .	Ciencia
México ratifica hegemonía Homeless Cup Corea Sur México ratificó hegemonía Homeless World Cup llevada cabo Seúl , Corea Sur , consagró máximo ganador torneo . selección varonil ganó 6-5 Inglaterra último momento evitar penales , obtuvieron quinto título , equipo femenil consiguió novena corona luego vencer Rumania 5-2 día ayer .	Deportes
ONU formula siete recomendaciones regular IA ONU creó año pasado órgano consultivo 39 miembros abordar problemas regulación internacional IA .	Ciencia
Rappi considera debutar Bolsa Nueva York año Rappi opera nueve países región es considerada unicornio tecnológico valoración supera 5,000 millones dólares .	Ciencia
Confirma Sheinbaum salida Gabriel Yorio Subsecretaría Hacienda subsecretario Hacienda , Gabriel Yorio González , no repetirá cargo próximo sexenio , así confirmó próxima titular Ejecutivo federal .	Economía
Calica no hubo expropiación , aplicó defensa territorio : AMLO “ No hay expropiación ” bancos materiales explotaba gigante minera Vulcan Materials costas Quintana Roo , aseveró presidente Andrés Manuel López Obrador .	Economía
voy conciencia tranquila arrepentimientos : Ana Guevara Convencida cumplió deber , pesar críticas afrontó llegada cargo 2018 , Ana Guevara aseguró ayer dejará dirección Comisión Nacional Cultura Física Deporte ( Conade ) arrepentimientos , conciencia tranquila segura no gozó sobreprotección administración .	Deportes
Caliente pasó anunciar apuestas transmitir Champions League compañía ha entrado ‘ guerra streaming deportivo ’ captar parte nicho mercado consolidar principal negocio : apuestas .	Ciencia
TelevisaUnivision nombra nuevo CEO exdirectivo Google trata Daniel Alegre , sustitución Wade Davis ,   cuenta amplia experiencia empresas tecnología trabajando comunidad hispana EU , México América Latina .	Ciencia
Fátima Herrera , miedo ,   hizo historia ring París 2024 surgimiento referentes deporte mujeres comienza forjar nuevos talentos . Inspira-da proezas Jackie Nava Ana María Guerrera Torres , Fátima Herrera peleó llegar París 2024 , hizo historia convertirse primera boxeadora mexicana conseguir victoria Juegos Olímpicos .	Deportes
Denuncian Visa monopolio Estados Unidos Departamento Justicia Estados Unidos busca denunciar empresa   monopolio mercado tarjetas débito , acuerdo reporte Blomberg .	Economia
Trump amaga arancel 100% autos entren frontera México candidato presidencial dijo única manera libren cuota es quieren construir planta Estados Unidos .	Economia
Eliminación subsidios gasolinas impedirá bajas precios medida disminución estímulos fiscales obedece más necesidad incrementar recaudación impuestos reducir déficit fiscal , consideran especialistas .	Economia
combate tradicional , acto resistencia espectacularidad wrestling estadunidense décadas años 50 60 lucha libre mexicana fue célebre combate ras lona , uso llaves máscaras multicolores convirtieron patrimonio cultural . 80 , influencia wrestling estadunidense , caracterizado espectacularidad uso múltiples objetos – mesas fuego , sillas escaleras – , impactó forma aficionados conciben deporte .	Deportes
China presenta medidas relajación monetaria reactivar economía Banco Popular China recortará tipo interés operaciones dobles siete días 0.2 puntos porcentuales , 1.5% .	Economia
Gasto bolsillo salud pega familias gastos médicos inesperados México pueden representar golpe bolsillo ciudadano , alcanzando costo medio nacional 117 mil 766 pesos 2023 , estimó Asociación Mexicana Instituciones Seguros ( AMIS ) .	Economía
Amazon agrega PayPal método pago pedidos Comprar Prime nueva opción estará disponible usuarios realicen compras sitios web terceros , membresía Prime .	Ciencia
OpenAI crea junta seguridad capaz detener nuevos lanzamientos empresa busca mejorar procesos protección , confianza transparencia medio búsqueda nueva ronda financiación multimillonaria .	Ciencia
Galardona Inbal tres grandes artistas tejieron lienzo plástica mexicana ” ovaciones vítores , escultora Geles Cabrera ( 1926 ) pintores Arturo Estrada ( 1925 ) Guillermo Monroy ( 1924 ) recibieron Medalla Bellas Artes Oro Artes Visuales 2023 2024 , ceremonia “ histórica ” , efectuada ayer sala Manuel M. Ponce Palacio Bellas Artes , encabezada Lucina Jiménez , titular Instituto Nacional Bellas Artes Literatura ( Inbal ) .	Cultura
Murió Fredric Jameson , crítico capitalismo   referente marxismo EU Fredric Jameson ( 1934 ) , crítico , teórico catedrático literario estadunidense , falleció domingo 90 años , informó editorial Verso Libros redes sociales .	Cultura
Infonavit maneja 2.4 billones pesos activos : Carlos Martínez fondos instituto han aumentado aumentos salariales , mayores aportaciones patronales , fiscalización empresas , programas regularización créditos .	Economia
identidad digital industria financiera : defensa arma biometría criptografía reducen riesgo suplantación identidad , también abre nuevos riesgos no hace adecuadamente .	Ciencia
Altán Redes confía gobierno Sheinbaum robustecerá conectividad Carlos Lerma , CEO Altán , dice estar “ positivo vendrá próximos años ” conectividad , debido provisión internet será ejes principales Claudia Sheinbaum .	Ciencia
Cifras verdes * llave programas planeación ciudades inteligentes verdes , bicicleta ha recuperado relevancia proyectos urbanos .	Economía
Reserva Federal EU ya no es referente política monetaria global bancos centrales países realizaron serie movimientos tasas interés semana , encabezados Reserva Federal Estados Unidos ( Fed ) , miércoles recortó tasas referencia primera vez 2020 .	Economía
Ciudades globo viven burbuja inmobiliaria : estudio Miami , Tokio Zúrich encabezan lista ciudades mayor riesgo burbuja inmobiliaria nivel mundial , debido elevada amenaza mercados vivienda , reveló UBS Global Real Estate Bubble Index 2024 .	Economía
YouTube presenta IA hacer videos ganar ‘ más ’ dinero empresa llevo cabo Made on YouTube evento también señaló número creadores obtienen mayor parte ingresos viene TV .	Ciencia
Pemex envía combustible Refinería Olmeca India Petróleos Mexicanos ( Pemex ) envió mes primer cargamento combustible nueva refinería Olmeca India , señal progreso después múltiples retrasos costos espiral , datos embarque fuentes industria .	Economía
UNAM celebró 60 años fundación Archivo Histórico Universidad Nacional Autónoma México ( UNAM ) celebró ayer 60 aniversario fundación Archivo Histórico ; además , inauguró exposición Archivo Histórico UNAM , ayer hoy .	Cultura
Gustavo Gordillo / III : Justicia , anillos , poder haya mayorías , tiene haber minorías . Son minorías , existencia política , constituyen régimen mayorías .	Economía
Cae dupla Zverev-Alcaraz dupla Carlos Alcaraz-Alexander Zverev cayó pareja estadunidense formada Taylor Fritz Ben Shelton , 7-6 ( 7/5 ) 6-4 , dejando marcador 2-2 final primera jornada Laver Cup , disputa Berlín . Impulsada Roger Federer 2017 , competencia – exhibición inspirada Ryder Cup golf llamada así homenaje jugador australiano Rod Laver – enfrenta seis jugadores Europa número representantes resto mundo .	Deportes
Tercer cuadrangular   mexicano Jonathan   Aranda Tampa Bay St . Petersburgo . , mexicano Jonathan Aranda pegó cuadrangular tercer partido consecutivo Rays Tampa Bay , vencieron 4-3 Azulejos completaron barrida serie tres juegos .	Deportes
"Yellen considera "" señal muy positiva "" recorte tasas Fed medida "" refleja confianza parte Fed inflación cedió está camino meta 2% ( anual ) "" , expresó secretaria Tesoro EU ."	Economia
es Antonio Martínez Dagnino , jefe SAT gobierno Sheinbaum Antonio Martínez Dagnino llegó jefatura SAT octubre 2022 , luego Raquel Buenrostro pasara tomar liderazgo Secretaría Economía .	Economia
Jefes continúan invictos ; superan 22-17 Halcones Atlanta . Patrick Mahomes lanzó par pases anotación defensiva Kansas City realizó par defensas tardías mantener Jefes invictos vencer 22-17 Halcones Atlanta .	Deportes
Amazon Prime MGM Studios unen MPA empresas entretenimiento unen Netflix Paramount Pictures .	Ciencia
Inauguran Museo Vivo Muralismo pasado , cambio gobierno vivía “ ruptura ” . “ sabe ” , dijo presidenta electa , Claudia Sheinbaum , sonrisa . ocasión fue inauguración Museo Vivo Muralismo ( MVM ) , edificio histórico Secretaría Educación Pública ( SEP ) .	Cultura
México impugnará fallo determina pago 37 mdd Odyssey Marine Exploration empresa estadounidense ganó arbitraje internacional México , consideró Semarnat negó arbitrariamente permiso proyecto minero marino Baja California Sur .	Economia
Secretario Arte Cultura Morena rinde informe actividades Secretario Arte Cultura Comité Ejecutivo Nacional ( CEN ) Morena , Tomás Pliego Calvo , indicó medio participación 22 comisiones estatales arte cultura , artistas , creadores , promotores , gestores culturales , colectivos cooperativas , organizados partir plan acción secretaría , “ realizaron tareas actividades defensa Cuarta Transformación ( 4 T ) , promoviendo cultura incluyente equitativa luchó lucha clasismo , racismo , machismo fascismo ” .	Cultura
Pumas femenil deja escapar tres puntos CU Pese generar oportunidades gol , Pumas no logró pa-sar empate 0-0 Querétaro , dejó escapar valiosos puntos permitieran afianzarse primeros lugares clasificación general torneo Apertura 2024 Liga Mx Femenil .	Deportes
Banxico mantendrá prudencia cerrará año tasa 10% analistas consideran mensaje banco central es más laxo decisión agosto esperan haya dos recortes más 25 puntos base .	Economia
EU prohibirá software hardware chinos vehículos Washington . Departamento Comercio Estados Unidos propondría lunes prohibir software hardware chinos vehículos conectados autónomos carreteras país debido preocupaciones seguridad nacional , dijeron fuentes Reuters .	Economía
Pablo Espinosa : creaturas habitan Bellas Artes luz distintas horas devora .	Cultura
"EU pide "" implementación rigurosa "" plan certificación aguacate México ventas aguacate mexicano Estados Unidos han disparado 48% 2019 , alcanzar valor más 3,000 millones dólares año pasado ."	Economia
¿ da Apple iPhone abonar compra nuevo ? programa Trade In recibe equipos iPhone 2020 15 Pro Max , bonificación máxima 20,000 pesos .	Ciencia
Angélica Azuara recomienda Jornada trinchera : puesto periódicos Angélica Azuara , puesto periódicos trabaja hace 15 años es también trinchera , ha tocado “ evadir recibir dardos censura sexenios anteriores , así mentes panistas cerradas hoy día ” .	Cultura
CNBV buscará regular reportes ciberseguridad regulador busca empresas ofrezcan servicio financiero deban homologar criterios reportar han sido víctimas ataque cibernético .	Economia
caso Caliente TV : anunciar apuestas transmitir Champions League compañía ha entrado ‘ guerra streaming deportivo ’ captar parte nicho mercado consolidar principal negocio : apuestas .	Ciencia
Es innecesaria reforma fiscal siguiente sexenio presidente Andrés Manuel López Obrador aseguró no es necesaria reforma fiscal futuro mantiene fórmula combate corrupción política austeridad republicana .	Economía
Real Madrid saca apurada victoria Alavés Madrid . Real Madrid es luz noche . ofrecer sábado versión más contundente visita Español Santiago Bernabéu , equipo blanco reveló costado más vulnerable apurada victoria 3-2 Alavés , cumplió año derrota Liga España .	Deportes
Marlene Santos Alejo : Balance jornada increíble parezca ,     equipos millonetas favoritos Liga Mx sufren perder estribos . América Monterrey empatan duras penas , Cruz Azul gana mínima ventaja Chivas sólo consiguen sumar frente coleros … emociones regaló fecha doble , dieron nota quejoso André Jardine , timonel amarillo , Ivar Sisniega , titular Federación Mexicana Futbol , preocupado bajas entradas Estados Unidos , pidió “ transmitir mensajes positivos apoyo selección ” .	Deportes
Charlyn Corral logra doblete mantiene invicto Pachuca ; empata 3-3 Chivas duelo vertiginoso , Charlyn Corral firmó doblete Pachuca igualara 3-3 Chivas mantuviera invicto primeros puestos , jornada once torneo Clausura 2024 Liga Mx Femenil . Tuzas suman 29 unidades estaban espera duelo Tigres Tijuana confirmar liderato , tapatías ubicaron quinto puesto 20 unidades temporadas más irregulares .	Deportes
Mexicanos gastan 12% más bebidas energéticas Datos Kantar muestran últimos años ha aumentado tanto número litros comprados precio tipo bebidas .	Economia
sequías impactan precio peso carne res : Banxico Banco México destacó sequías provocan productores carne sacrifiquen ganado antes tiempo no pierdan peso ; llega provocar inflación mediano plazo .	Economia
Mexico necesita política industrial acorde economía actual : IMCO centro investigación apunta últimos 20 años , valor agregado producción exportaciones manufactureras ha estancado .	Economia
IA generativa transforma operación ingresos empresariales uso IA generativa ha crecido sectores , impulsando innovación facilitando nuevas formas operar organizaciones .	Ciencia
Ohtani desata euforia   prensa japonesa proeza Shohei Ohtani , convirtió primer pelotero Grandes Ligas 50 jonrones 50 bases robadas temporada , fue celebrada ediciones extra periódicos aficio-nados leyeran camino trabajo viernes Japón .	Deportes
Orlando Delgado Selley : Balance desafíos Ha llegado final primera administración federal 4T. Es posible hacer balance ponderado funcionamiento economía . balance necesario , además , establece base plantear desafíos enfrentará nueva administración periodo gobierno , particularmente , primer año . supuesto , primera cuestión es sexenio AMLO economía mexicana enfrentó crisis derivada covid , afectó países , diferente medida .	Economía
déficit fiscal México crece 54% agosto supera billón pesos Secretaría Hacienda Crédito Público destacó Requerimientos Financieros Sector Público sumaron 1.109 billones pesos .	Economia
Netflix Prime Video Amazon lideran quejas streaming agosto año , ambas empresas recibieron inconformidades parte usuarios cobros indebidos alteración precios , aseguró Profeco Expansión través transparencia .	Ciencia
BBVA mantiene confianza México transición presidencial país sigue siendo atractivo largo plazo gracias estructura costos apalancamiento comparación Estados Unidos , dijo Onur Genç , consejero delegado BBVA .	Economia
¿ servicio cliente manos IA es mejor humanos ? Más mitad profesionales servicio cliente ya ocupan software impulsado IA espera continúe creciendo .	Ciencia
inconformidad justicia mexicana , acreedores TV Azteca inician proceso Secretaría Economía informó disputa internacional México , impago bonos TV Azteca , acumula costo 150,000 dólares concepto honorarios CIADI .	Ciencia
tomar cuenta semana inicia darán conocer reportes , inflación , ventas menudeo , indicador actividad económica , balanza comercial anuncio política monetaria , .	Economía
Vendaval americanistas ; Águilas golean Rayadas 4-2 Monterrey tardó más 70 minutos meterse partido . finalmente despertó , América ya goleaba tenía prácticamente triunfo bolsa . 4-2 sentenció exhibición más desconcertante paupérrima Rayadas campaña . abucheos afición , más rostros desencajados jugadora terreno juego , reflejaron diferencia existe respecto Águilas .	Deportes
Inflación agroalimentaria va baja , aún hay productos incrementos arriba 60% primera quincena septiembre tanto inflación general agroalimentaria presentaron reducciones significativas ; embargo , aún existen productos factores , clima estacionalidad , registran incrementos anuales encima 60 ciento anual casos fresa cebolla .	Economía
Instagram lanza cuenta adolescentes controles parentales usuarios menores 16 años sólo podrán recibir mensajes ser etiquetados cuentas sigan ya estén conectados .	Ciencia
Aseguran Guardianes descanso postemporada vencer 6-1 Rojos Cleveland . Guardianes Cleveland , campeones División Central Liga Americana , aseguraron descanso primera ronda playoffs vencer 6-1 Rojos Cincinnati . Lane Thomas pegó jonrón dos anotaciones empujó tres carreras Josh Naylor sumó par remolcadas .	Deportes
SAT obtiene 191,506 mdp eficiencia recaudatoria 2024 mayor eficiencia recaudatoria debe principalmente programas Cumplimiento Obligaciones , Vigilancia Profunda Cobranza Coactiva .	Economia
Banco Mundial logra récord 56,000 mdd inversiones CFI ejercicio financiero finalizará julio 2025 , Banco Mundial buscará centrar esfuerzos infraestructura , particularmente carreteras transporte .	Economia
Guía elegir mejor antivirus celular ataques teléfonos inteligentes vez son más comunes aquí decimos debes tener cuenta hora elegir mejor protección .	Ciencia
número súper ricos dispara Estados Unidos China población China menos 100 millones dólares cuentas ha duplicado últimos 10 años .	Economia
Anuncios inversión México suman 59,900 mdd primeros nueve meses 2024 Secretaría Economía identifica 197 anuncios públicos enero septiembre . Estados Unidos encabeza anuncios .	Economia
Emilio Payán : Litógrafa Popular artista grabador Joel Rendón ( 1967 ) impresor Fernando Riquelme ( 1990 ) fundaron hace dos meses Litógrafa Popular , taller reunión , diálogo intercambio experiencias conservar tradición técnica México . proyecto rinde homenaje madre tierra considerar piedra litográfica matriz creadora estrecha conexión tierra vida . Litógrafa Popular surgió objetivo conservar estética estampa gráfica popular cargada identidad sentido social .	Cultura
Lando Norris supera Verstappen Gran Premio Singapur Singapur . Lando Norris sorteó par sustos muros ganar contundencia Gran Premio Singapur , apenas pudo recortar siete puntos diferencia Max Verstappen líder campeonato Fórmula Uno . resultado mexicano Sergio Pérez fue completamente inesperado , terminar décimo lugar dificultades rebasar , llevó último punto repartió carrera .	Deportes
Cede lluvia arranca primer partido miniliga Pacífico lluvia cedió horas fin salió Sol . fuera señal sagrada fanáticos beisbol , aguardaron par días tormentosos pudie-ra empezar minitorneo Liga Mexicana Pacífico estadio Fray Nano Ciudad México , movió prisa ganarle partida mal tiempo . así fin arrancó primer juego Cañeros Mochis derrotaron 4-0 Sultanes Monterrey . resto partidos aún dependerán condiciones climáticas .	Deportes
Slim critica dinero gasta jubilados pide combatir pobreza hombre más rico México dice recursos reciben actualmente mayores 65 años debería usarse sacar 6 millones personas pobreza extrema .	Economia
TelevisaUnivisión sustituirá Wade Davis director general empresa decidió sustituir Davis Daniel Alegre debido resultados compañía cayeron debajo expectativas internas .	Ciencia
extremis , Águilas rescatan   valioso empate 1-1 Necaxa gol agónico Henry Martín , América rescató valioso empate 1-1 Necaxa , hilvanó tres partidos conocer derrota , ayer due-lo correspondiente jornada nueve torneo Apertura 2024 Liga Mx , disputado estadio Victoria , Aguascalientes .	Deportes
Elena Poniatowska : Miguel Ángel Salazar González , Diablo Paula Haro , hija , hizo muy amiga Diablo , venía buscarla Chimalistac después limpiar parabrisas Insurgentes Miguel Ángel Quevedo . Flaquito , huesudo , sonriente , pelo negro cortina ojos , Diablo llegaba desayunar , comer merendar . No rechazaba ofrecimiento regaderazo agua caliente . Después casi 20 minutos agua , aparecía ropa sonrisa resplandecía .	Cultura
Banxico ejecuta nuevo recorte tasa 10.5% banco central hizo segundo recorte consecutivo tasa referencia contexto menor inflación .	Economia
Venta gasolinas Pemex aumentó 2.8% volumen ventas gasolinas Petróleos Mexicanos ( Pemex ) agosto promedió 687 mil barriles diarios , dato mostró avance 2.8 ciento frente igual periodo año pasado , revelan estadísticas empresa estatal .	Economía
India , país quiere ser potencia industria semiconductores Estados Unidos India anunciaron alianza construir planta chips país , gobierno Biden definió “ punto inflexión ” .	Ciencia
Telefónica Megacable aplican medidas seguridad Culiacán compañías telecomunicaciones decidieron modificar operación sucursales garantizar seguridad trabajadores entidad ha sido azotada violencia .	Ciencia
Líderes tecnológicos   acudirán Casa Blanca hablar IA : CNN Funcionarios alto rango líderes tecnológicos darán cita hablar recursos energéticos infraestructura necesarios impulsar herramienta .	Ciencia
Amazon despide home office : empleados regresan oficina 2025 empresas han permitido empleados trabajen casa pandemia , ha dejado oficinas casi vacías ciudades San Francisco Seattle .	Ciencia
Termina semana peso pérdida ciento peso cerró retroceso ciento semana , marcada anuncio política monetaria banco central Estados Unidos también afectado cautela inversionistas aguardan anuncio Banco México próxima semana .	Economía
Lun representa escena magia infancia enigma existencia magia infancia , enigma existencia riesgos pérdida memoria entrelazan Lun , propuesta escénica llega Teatro Artes Centro Nacional Artes ( Cenart ) , partir fin semana .	Cultura
menopausia puede ocasionar problemas dentales , dicen especialistas sofocos sudoraciones nocturnas son síntomas más infames menopausia . es posible también desee prestar atención dientes encías .	Ciencia
Regresa vivo Met Nueva York Auditorio Nacional ocho títulos temporada 2024-2025 programa vivo Met Nueva York , transmitirá 5 octubre 31 mayo pantalla gigante Auditorio Nacional , siguen fiel misión Metropolitan Opera House presentar óperas “ más famosas populares ” , mejores elencos posibles , así ofrecer producciones nuevas , “ sólo así avanzará forma arte ” , expresó Peter Gelb , gerente general Met .	Cultura
Francia reconoce obra Graciela Iturbide “ Hablo poco francés , entiendo más Francia ” , aseguró fotógrafa Graciela Iturbide “ parodiando Alfonso Reyes , ser condecorada Orden Artes Letras rango oficial República Francesa , acto cargo embajadora gala Delphine Borione .	Cultura
Fomentar vivienda interés social eliminar corrupción , retos Infonavit Analistas señalan instituto tiene pendientes materia avanzar digitalización agilización trámites , así mejorar rendimientos subcuenta vivienda .	Economia
inversión extranjera cae estados más “ atractivos ” nearshoring falta energía eléctrica , escasez agua mano obra , además infraestructura rebasada transporte ponen freno decisiones inversión .	Economia
